AA	AA
ABA	ABA
ABO	OBA
ABOS	SOBA
ABUT	TUBA
ADO	ODA
ADOS	SODA
AGA	AGA
AGAS	SAGA
AGENES	SENEGA
AH	HA
AHA	AHA
AIDER	REDIA
AIR	RIA
AIRTS	STRIA
AJAR	RAJA
AL	LA
ALA	ALA
ALIF	FILA
ALULA	ALULA
AMA	AMA
AMIS	SIMA
AN	NA
ANA	ANA
ANIMAL	LAMINA
ANIMES	SEMINA
ANNA	ANNA
ANTE	ETNA
APOD	DOPA
ARB	BRA
ARE	ERA
ARES	SERA
ARIL	LIRA
ARRIS	SIRRA
ARUM	MURA
AT	TA
ATE	ETA
ATES	SETA
AUKS	SKUA
AVA	AVA
AVO	OVA
AWA	AWA
BA	AB
BAG	GAB
BAL	LAB
BALS	SLAB
BAN	NAB
BARD	DRAB
BAS	SAB
BAT	TAB
BATS	STAB
BED	DEB
BEEF	FEEB
BEN	NEB
BIB	BIB
BIG	GIB
BIN	NIB
BINS	SNIB
BIRD	DRIB
BIS	SIB
BLUB	BULB
BOB	BOB
BONK	KNOB
BOOB	BOOB
BOTS	STOB
BOWS	SWOB
BOY	YOB
BRAD	DARB
BRAG	GARB
BRO	ORB
BROS	SORB
BUB	BUB
BUN	NUB
BUNS	SNUB
BUR	RUB
BURD	DRUB
BURG	GRUB
BUS	SUB
BUT	TUB
BUTS	STUB
CAM	MAC
CAP	PAC
CARES	SERAC
CAT	TAC
CEP	PEC
CEPS	SPEC
CIS	SIC
CITE	ETIC
CIVIC	CIVIC
COR	ROC
CRAM	MARC
DAB	BAD
DAG	GAD
DAH	HAD
DAHS	SHAD
DAL	LAD
DAM	MAD
DAP	PAD
DART	TRAD
DAW	WAD
DE	ED
DEBUT	TUBED
DECAF	FACED
DECAL	LACED
DEDAL	LADED
DEED	DEED
DEEP	PEED
DEEPS	SPEED
DEER	REED
DEES	SEED
DEET	TEED
DEETS	STEED
DEF	FED
DEFER	REFED
DEFFER	REFFED
DEGAMI	IMAGED
DEIFIED	DEIFIED
DEIL	LIED
DEKE	EKED
DEKED	DEKED
DELED	DELED
DELIVER	REVILED
DELS	SLED
DEMIT	TIMED
DENIER	REINED
DENIES	SEINED
DENIM	MINED
DENNED	DENNED
DEPOT	TOPED
DEPOTS	STOPED
DERAT	TARED
DERATS	STARED
DESSERT	TRESSED
DESSERTS	STRESSED
DEVAS	SAVED
DEVIL	LIVED
DEW	WED
DEWANS	SNAWED
DEWED	DEWED
DIAL	LAID
DIALER	RELAID
DIAPER	REPAID
DIB	BID
DIF	FID
DIG	GID
DIM	MID
DINAR	RANID
DIOL	LOID
DIOLS	SLOID
DIVA	AVID
DOC	COD
DOM	MOD
DON	NOD
DOOM	MOOD
DOOR	ROOD
DOR	ROD
DORMIN	NIMROD
DORP	PROD
DOS	SOD
DOSER	RESOD
DOT	TOD
DRAIL	LIARD
DRAW	WARD
DRAWER	REWARD
DRAWS	SWARD
DRAY	YARD
DUAL	LAUD
DUB	BUD
DUEL	LEUD
DUO	OUD
DUP	PUD
DUPS	SPUD
EAT	TAE
EDILE	ELIDE
EDIT	TIDE
EEL	LEE
EF	FE
EH	HE
EKE	EKE
EM	ME
EME	EME
EMIR	RIME
EMIT	TIME
EMITS	STIME
EN	NE
ENOL	LONE
ER	RE
ERE	ERE
EROS	SORE
ERVIL	LIVRE
ESNES	SENSE
ETAS	SATE
EVE	EVE
EVIL	LIVE
EVILER	RELIVE
EWE	EWE
FER	REF
FIR	RIF
FIRES	SERIF
FLED	DELF
FLOW	WOLF
FOOL	LOOF
GAG	GAG
GALS	SLAG
GAM	MAG
GAN	NAG
GAR	RAG
GAS	SAG
GAT	TAG
GATEMAN	NAMETAG
GATER	RETAG
GATS	STAG
GAY	YAG
GEL	LEG
GELDER	REDLEG
GEM	MEG
GEN	NEG
GET	TEG
GIG	GIG
GIRT	TRIG
GNAR	RANG
GNAT	TANG
GNATS	STANG
GNAWS	SWANG
GNUS	SUNG
GOB	BOG
GOLF	FLOG
GOT	TOG
GUL	LUG
GULP	PLUG
GULS	SLUG
GUM	MUG
GUMS	SMUG
GUNS	SNUG
GUT	TUG
GUV	VUG
HABUS	SUBAH
HAH	HAH
HALALAH	HALALAH
HALLAH	HALLAH
HAY	YAH
HEH	HEH
HEY	YEH
HO	OH
HON	NOH
HOOP	POOH
HOP	POH
HUH	HUH
IS	SI
IT	TI
JAR	RAJ
KAIAK	KAIAK
KAYAK	KAYAK
KEEL	LEEK
KEELS	SLEEK
KEEP	PEEK
KEETS	STEEK
KIPS	SPIK
KITHS	SHTIK
KNAPS	SPANK
KNAR	RANK
KNITS	STINK
KNOW	WONK
KOOK	KOOK
LAG	GAL
LAIR	RIAL
LAP	PAL
LARES	SERAL
LARUM	MURAL
LAS	SAL
LED	DEL
LEES	SEEL
LEET	TEEL
LEETS	STEEL
LEPER	REPEL
LES	SEL
LET	TEL
LEVEL	LEVEL
LEVINS	SNIVEL
LIAR	RAIL
LIN	NIL
LION	NOIL
LIT	TIL
LOBO	OBOL
LOOM	MOOL
LOONS	SNOOL
LOOP	POOL
LOOPS	SPOOL
LOOT	TOOL
LOOTER	RETOOL
LOOTS	STOOL
LOP	POL
LOTOS	SOTOL
MA	AM
MADAM	MADAM
MAN	NAM
MAP	PAM
MAPS	SPAM
MAR	RAM
MARCS	SCRAM
MARRAM	MARRAM
MAT	TAM
MAWS	SWAM
MAY	YAM
MEED	DEEM
MEM	MEM
MHO	OHM
MILS	SLIM
MIM	MIM
MIR	RIM
MIS	SIM
MM	MM
MOM	MOM
MOOR	ROOM
MOOT	TOOM
MOP	POM
MOR	ROM
MOS	SOM
MOT	TOM
MU	UM
MUM	MUM
MUS	SUM
MUTON	NOTUM
MUTS	STUM
NAAN	NAAN
NAMER	REMAN
NAN	NAN
NAPS	SPAN
NAW	WAN
NEEP	PEEN
NEMA	AMEN
NEVE	EVEN
NEW	WEN
NIP	PIN
NIPS	SPIN
NIT	TIN
NO	ON
NOLOS	SOLON
NOM	MON
NONET	TENON
NOON	NOON
NOS	SON
NOT	TON
NOTES	SETON
NOW	WON
NU	UN
NUN	NUN
NUT	TUN
NUTS	STUN
OAT	TAO
OD	DO
OHO	OHO
ONO	ONO
OOT	TOO
OS	SO
OTTO	OTTO
OXO	OXO
PACER	RECAP
PAH	HAP
PAN	NAP
PAP	PAP
PART	TRAP
PARTS	STRAP
PAS	SAP
PAT	TAP
PAW	WAP
PAWS	SWAP
PAY	YAP
PEELS	SLEEP
PEEP	PEEP
PEH	HEP
PER	REP
PERP	PREP
PETS	STEP
PIG	GIP
PIP	PIP
PIT	TIP
POLS	SLOP
POOLS	SLOOP
POONS	SNOOP
POOP	POOP
PORT	TROP
PORTS	STROP
POT	TOP
POTS	STOP
POW	WOP
POWS	SWOP
PRAT	TARP
PROG	GORP
PUP	PUP
PURIS	SIRUP
PUS	SUP
PUT	TUP
RADAR	RADAR
RAP	PAR
RAT	TAR
RATS	STAR
RAW	WAR
RAY	YAR
REBUS	SUBER
REBUT	TUBER
RECAPS	SPACER
REDDER	REDDER
REDIPS	SPIDER
REDRAW	WARDER
REDRAWER	REWARDER
REEL	LEER
REFER	REFER
REFLOW	WOLFER
REGAL	LAGER
REIFIED	DEIFIER
REKNIT	TINKER
REKNITS	STINKER
RELIT	TILER
REMEET	TEEMER
REMIT	TIMER
RENNET	TENNER
REPAPER	REPAPER
REPOT	TOPER
REPOTS	STOPER
RES	SER
RETEM	METER
REVEL	LEVER
ROT	TOR
ROTATOR	ROTATOR
SAGAS	SAGAS
SALLETS	STELLAS
SAPS	SPAS
SAROS	SORAS
SAT	TAS
SCAM	MACS
SEAM	MAES
SEDER	REDES
SEEKS	SKEES
SEEP	PEES
SEES	SEES
SELAHS	SHALES
SELLES	SELLES
SEMEMES	SEMEMES
SERACS	SCARES
SERUM	MURES
SEXED	DEXES
SHA	AHS
SHAHS	SHAHS
SIKAS	SAKIS
SIRS	SRIS
SIS	SIS
SIX	XIS
SKEETS	STEEKS
SKIPS	SPIKS
SLAP	PALS
SLEET	TEELS
SLEETS	STEELS
SLIPUP	PUPILS
SLOOPS	SPOOLS
SMART	TRAMS
SMUTS	STUMS
SNAP	PANS
SNAW	WANS
SNAWS	SWANS
SNED	DENS
SNIPER	REPINS
SNIT	TINS
SNOOPS	SPOONS
SNOOT	TOONS
SNOT	TONS
SNOW	WONS
SOB	BOS
SORTER	RETROS
SOW	WOS
SPANS	SNAPS
SPAT	TAPS
SPAY	YAPS
SPAZ	ZAPS
SPEELS	SLEEPS
SPIRT	TRIPS
SPIRTS	STRIPS
SPIT	TIPS
SPORTS	STROPS
SPOT	TOPS
SPOTS	STOPS
SPRAT	TARPS
SPRITS	STIRPS
STAT	TATS
STATS	STATS
STET	TETS
STETS	STETS
STOT	TOTS
STOTS	STOTS
STOWS	SWOTS
STRAW	WARTS
STROW	WORTS
STRUTS	STURTS
SULU	ULUS
SULUS	SULUS
SWAT	TAWS
SWAY	YAWS
SWOT	TOWS
TAROK	KORAT
TAV	VAT
TAW	WAT
TEEM	MEET
TEN	NET
TERCES	SECRET
TET	TET
TILS	SLIT
TIT	TIT
TOROT	TOROT
TOT	TOT
TRAM	MART
TROW	WORT
TUT	TUT
VAV	VAV
WATS	STAW
WAY	YAW
WET	TEW
WO	OW
WOTS	STOW
YA	AY
YAY	YAY
