AAH	AA	AAHAA
AAL	AA	AALAA
AAS	AA	AASAA
ABA	BA	ABABA
ABACA	BA	ABACABA
ABAKA	BA	ABAKABA
ABAS	ABA	ABASABA
ABASES	ABA	ABASESABA
ABAYA	BA	ABAYABA
ABBAS	ABBA	ABBASABBA
ABELE	BA	ABELEBA
ABO	BA	ABOBA
ABODED	OBA	ABODEDOBA
ABOS	OBA	ABOSOBA
ABS	BA	ABSBA
ABUSE	SUBA	ABUSESUBA
ABUTS	TUBA	ABUTSTUBA
ABY	BA	ABYBA
ACROSS	ORCA	ACROSSORCA
ADORER	ODA	ADORERODA
ADOS	ODA	ADOSODA
AFF	FA	AFFFA
AFT	FA	AFTFA
AGAR	AGA	AGARAGA
AGAS	AGA	AGASAGA
AGGADA	DAGGA	AGGADADAGGA
AHA	HA	AHAHA
AHI	HA	AHIHA
AHS	HA	AHSHA
AIDERS	REDIA	AIDERSREDIA
AIRN	RIA	AIRNRIA
AIRS	RIA	AIRSRIA
AIRT	RIA	AIRTRIA
AIRY	RIA	AIRYRIA
AKENE	KA	AKENEKA
ALA	LA	ALALA
ALAE	ALA	ALAEALA
ALAN	ALA	ALANALA
ALAND	NALA	ALANDNALA
ALANE	NALA	ALANENALA
ALANG	NALA	ALANGNALA
ALANIN	ALA	ALANINALA
ALANS	NALA	ALANSNALA
ALANT	NALA	ALANTNALA
ALAR	ALA	ALARALA
ALAS	ALA	ALASALA
ALATE	TALA	ALATETALA
ALB	LA	ALBLA
ALBATA	TABLA	ALBATATABLA
ALE	LA	ALELA
ALEE	LA	ALEELA
ALIBI	LA	ALIBILA
ALL	LA	ALLLA
ALLOBAR	ABOLLA	ALLOBARABOLLA
ALLOD	OLLA	ALLODOLLA
ALLOT	OLLA	ALLOTOLLA
ALLOW	OLLA	ALLOWOLLA
ALLOY	OLLA	ALLOYOLLA
ALLYL	LA	ALLYLLA
ALP	LA	ALPLA
ALS	LA	ALSLA
ALT	LA	ALTLA
ALULAE	ALULA	ALULAEALULA
ALULAR	ALULA	ALULARALULA
AMA	MA	AMAMA
AMAH	AMA	AMAHAMA
AMANITIN	AMA	AMANITINAMA
AMAS	AMA	AMASAMA
AMASS	AMA	AMASSAMA
AMEND	NEMA	AMENDNEMA
AMENDED	NEMA	AMENDEDNEMA
AMENS	NEMA	AMENSNEMA
AMENT	NEMA	AMENTNEMA
AMI	MA	AMIMA
AMICI	MA	AMICIMA
AMISS	SIMA	AMISSSIMA
AMMOCETE	COMMA	AMMOCETECOMMA
AMP	MA	AMPMA
AMU	MA	AMUMA
ANA	NA	ANANA
ANAL	ANA	ANALANA
ANAS	ANA	ANASANA
AND	NA	ANDNA
ANE	NA	ANENA
ANELE	NA	ANELENA
ANGERS	REGNA	ANGERSREGNA
ANI	NA	ANINA
ANIMALS	LAMINA	ANIMALSLAMINA
ANIME	MINA	ANIMEMINA
ANIMI	NA	ANIMINA
ANIMI	MINA	ANIMIMINA
ANNAL	ANNA	ANNALANNA
ANNAS	ANNA	ANNASANNA
ANODE	DONA	ANODEDONA
ANT	NA	ANTNA
ANTED	ETNA	ANTEDETNA
ANTES	ETNA	ANTESETNA
ANY	NA	ANYNA
APE	PA	APEPA
APING	NIPA	APINGNIPA
APO	PA	APOPA
APODS	DOPA	APODSDOPA
APOLLO	PA	APOLLOPA
APP	PA	APPPA
APSE	SPA	APSESPA
APSES	PA	APSESPA
APSIS	PA	APSISPA
APT	PA	APTPA
ARAME	MARA	ARAMEMARA
ARBS	BRA	ARBSBRA
AREA	ERA	AREAERA
ARES	ERA	ARESERA
ARILS	LIRA	ARILSLIRA
ARROW	ORRA	ARROWORRA
ARUMS	MURA	ARUMSMURA
ATE	TA	ATETA
ATES	ETA	ATESETA
ATONE	NOTA	ATONENOTA
ATONY	NOTA	ATONYNOTA
ATT	TA	ATTTA
AVOS	OVA	AVOSOVA
AVOW	OVA	AVOWOVA
AWAY	AWA	AWAYAWA
AYE	YA	AYEYA
AYS	YA	AYSYA
AZO	ZA	AZOZA
BAA	AB	BAAAB
BACH	CAB	BACHCAB
BACILLI	CAB	BACILLICAB
BACK	CAB	BACKCAB
BAD	AB	BADAB
BADE	DAB	BADEDAB
BADS	DAB	BADSDAB
BAFF	AB	BAFFAB
BAFF	FAB	BAFFFAB
BAG	AB	BAGAB
BAGS	GAB	BAGSGAB
BAH	AB	BAHAB
BAL	AB	BALAB
BALATA	LAB	BALATALAB
BALD	LAB	BALDLAB
BALDED	LAB	BALDEDLAB
BALE	LAB	BALELAB
BALK	LAB	BALKLAB
BALL	AB	BALLAB
BALL	LAB	BALLLAB
BALM	LAB	BALMLAB
BALS	LAB	BALSLAB
BALSA	SLAB	BALSASLAB
BAM	AB	BAMAB
BAN	AB	BANAB
BANANA	NAB	BANANANAB
BAND	NAB	BANDNAB
BANDED	NAB	BANDEDNAB
BANE	NAB	BANENAB
BANG	NAB	BANGNAB
BANI	NAB	BANINAB
BANK	NAB	BANKNAB
BANS	NAB	BANSNAB
BAP	AB	BAPAB
BAR	AB	BARAB
BARCA	CRAB	BARCACRAB
BARDE	DRAB	BARDEDRAB
BARER	AB	BARERAB
BARGE	GRAB	BARGEGRAB
BARGEE	GRAB	BARGEEGRAB
BAS	AB	BASAB
BASES	AB	BASESAB
BASIS	AB	BASISAB
BASKS	AB	BASKSAB
BASS	AB	BASSAB
BASTS	AB	BASTSAB
BAT	AB	BATAB
BATE	TAB	BATETAB
BATH	TAB	BATHTAB
BATS	TAB	BATSTAB
BATT	AB	BATTAB
BATT	TAB	BATTTAB
BAWD	WAB	BAWDWAB
BAWL	WAB	BAWLWAB
BAY	AB	BAYAB
BEDDED	DEB	BEDDEDDEB
BEDS	DEB	BEDSDEB
BEDU	DEB	BEDUDEB
BEEFS	FEEB	BEEFSFEEB
BEEFY	FEEB	BEEFYFEEB
BEND	NEB	BENDNEB
BENDED	NEB	BENDEDNEB
BENE	NEB	BENENEB
BIGEYE	GIB	BIGEYEGIB
BIGS	GIB	BIGSGIB
BILE	LIB	BILELIB
BILGE	GLIB	BILGEGLIB
BIMA	MIB	BIMAMIB
BIND	NIB	BINDNIB
BINE	NIB	BINENIB
BINS	NIB	BINSNIB
BINT	NIB	BINTNIB
BIRCH	CRIB	BIRCHCRIB
BIRD	RIB	BIRDRIB
BIRDED	RIB	BIRDEDRIB
BIRDS	DRIB	BIRDSDRIB
BIRDSEYES	DRIB	BIRDSEYESDRIB
BIREME	RIB	BIREMERIB
BISE	SIB	BISESIB
BISK	SIB	BISKSIB
BLAB	ALB	BLABALB
BLADED	ALB	BLADEDALB
BLAE	ALB	BLAEALB
BLAFF	ALB	BLAFFALB
BLAH	ALB	BLAHALB
BLAM	ALB	BLAMALB
BLASTS	ALB	BLASTSALB
BLAT	ALB	BLATALB
BLAW	ALB	BLAWALB
BLUBS	BULB	BLUBSBULB
BOCK	COB	BOCKCOB
BOFF	FOB	BOFFFOB
BOLD	LOB	BOLDLOB
BOLE	LOB	BOLELOB
BOLETE	LOB	BOLETELOB
BOLL	LOB	BOLLLOB
BOLO	LOB	BOLOLOB
BOMB	MOB	BOMBMOB
BOND	NOB	BONDNOB
BONDED	NOB	BONDEDNOB
BONE	NOB	BONENOB
BONG	NOB	BONGNOB
BONK	NOB	BONKNOB
BONKS	KNOB	BONKSKNOB
BONOBO	NOB	BONOBONOB
BONY	NOB	BONYNOB
BORA	ROB	BORAROB
BORDERED	ROB	BORDEREDROB
BORE	ROB	BOREROB
BOSH	SOB	BOSHSOB
BOSK	SOB	BOSKSOB
BOSS	SOB	BOSSSOB
BOSSES	SOB	BOSSESSOB
BOWSE	SWOB	BOWSESWOB
BRACH	CARB	BRACHCARB
BRAD	ARB	BRADARB
BRAE	ARB	BRAEARB
BRAG	ARB	BRAGARB
BRAGS	GARB	BRAGSGARB
BRAN	ARB	BRANARB
BRAS	ARB	BRASARB
BRASS	ARB	BRASSARB
BRAT	ARB	BRATARB
BRAW	ARB	BRAWARB
BRAY	ARB	BRAYARB
BREVE	VERB	BREVEVERB
BROO	ORB	BROOORB
BROS	ORB	BROSORB
BROSE	SORB	BROSESORB
BROSES	ORB	BROSESORB
BROSY	SORB	BROSYSORB
BRUT	URB	BRUTURB
BRUX	URB	BRUXURB
BRUXED	EXURB	BRUXEDEXURB
AB	BUBBA	ABBUBBA
BUDDED	DUB	BUDDEDDUB
BUDS	DUB	BUDSDUB
BUFF	FUB	BUFFFUB
BUHL	HUB	BUHLHUB
BUHR	HUB	BUHRHUB
BUNA	NUB	BUNANUB
BUND	NUB	BUNDNUB
BUNG	NUB	BUNGNUB
BUNK	NUB	BUNKNUB
BUNN	NUB	BUNNNUB
BUNS	NUB	BUNSNUB
BUNT	NUB	BUNTNUB
BURA	RUB	BURARUB
BURB	RUB	BURBRUB
BURD	RUB	BURDRUB
BURDENED	RUB	BURDENEDRUB
BURDS	DRUB	BURDSDRUB
BURETTE	RUB	BURETTERUB
BURG	RUB	BURGRUB
BURGEE	GRUB	BURGEEGRUB
BURGH	GRUB	BURGHGRUB
BURGOO	GRUB	BURGOOGRUB
BURGS	GRUB	BURGSGRUB
BUTE	TUB	BUTETUB
BUTENE	TUB	BUTENETUB
BUTS	TUB	BUTSTUB
BUTT	TUB	BUTTTUB
CALCIC	LAC	CALCICLAC
CALCIFIC	LAC	CALCIFICLAC
CALCITIC	LAC	CALCITICLAC
CALF	LAC	CALFLAC
CALK	LAC	CALKLAC
CALL	LAC	CALLLAC
CAME	MAC	CAMEMAC
CAMO	MAC	CAMOMAC
CAMP	MAC	CAMPMAC
CAMS	MAC	CAMSMAC
CAPE	PAC	CAPEPAC
CAPH	PAC	CAPHPAC
CAPO	PAC	CAPOPAC
CAPS	PAC	CAPSPAC
CARESS	SERAC	CARESSSERAC
CARESSES	SERAC	CARESSESSERAC
CASA	SAC	CASASAC
CASABA	SAC	CASABASAC
CASAVA	SAC	CASAVASAC
CASE	SAC	CASESAC
CASETTE	SAC	CASETTESAC
CASH	SAC	CASHSAC
CASINI	SAC	CASINISAC
CASK	SAC	CASKSAC
CATE	TAC	CATETAC
CATS	TAC	CATSTAC
CAVALLA	VAC	CAVALLAVAC
CAVE	VAC	CAVEVAC
CAVY	VAC	CAVYVAC
CEPE	PEC	CEPEPEC
CEPS	PEC	CEPSPEC
CERE	REC	CEREREC
CESS	SEC	CESSSEC
CESSES	SEC	CESSESSEC
CIMEX	EMIC	CIMEXEMIC
CIST	SIC	CISTSIC
CITE	TIC	CITETIC
CITED	ETIC	CITEDETIC
CITER	ETIC	CITERETIC
CITES	ETIC	CITESETIC
CITOLE	LOTIC	CITOLELOTIC
CITY	TIC	CITYTIC
CIVICS	CIVIC	CIVICSCIVIC
CODA	DOC	CODADOC
CODDED	DOC	CODDEDDOC
CODE	DOC	CODEDOC
CODS	DOC	CODSDOC
COLBY	BLOC	COLBYBLOC
COMA	MOC	COMAMOC
CORD	ROC	CORDROC
CORDED	ROC	CORDEDROC
CORDELLED	ROC	CORDELLEDROC
CORE	ROC	COREROC
CORF	ROC	CORFROC
CORK	ROC	CORKROC
CORM	ROC	CORMROC
CORN	ROC	CORNROC
CORS	ROC	CORSROC
CORSES	ROC	CORSESROC
CORY	ROC	CORYROC
CRAB	ARC	CRABARC
CRAG	ARC	CRAGARC
CRAM	ARC	CRAMARC
CRANE	NARC	CRANENARC
CRANK	NARC	CRANKNARC
CRAP	ARC	CRAPARC
CRASES	ARC	CRASESARC
CRASIS	ARC	CRASISARC
CRASS	ARC	CRASSARC
CRAW	ARC	CRAWARC
CROC	ORC	CROCORC
CROP	ORC	CROPORC
CROSS	ORC	CROSSORC
CROW	ORC	CROWORC
CYMA	MYC	CYMAMYC
DAB	AD	DABAD
DABS	BAD	DABSBAD
DACE	CAD	DACECAD
DAD	AD	DADAD
DADA	DAD	DADADAD
DADO	DAD	DADODAD
DADS	DAD	DADSDAD
DAFF	AD	DAFFAD
DAG	AD	DAGAD
DAH	AD	DAHAD
DAHL	HAD	DAHLHAD
DAHS	HAD	DAHSHAD
DAK	AD	DAKAD
DAL	AD	DALAD
DALASI	SALAD	DALASISALAD
DALE	LAD	DALELAD
DAM	AD	DAMAD
DAME	MAD	DAMEMAD
DAMN	MAD	DAMNMAD
DAMP	MAD	DAMPMAD
DAMS	MAD	DAMSMAD
DAN	AD	DANAD
DAP	AD	DAPAD
DAPS	PAD	DAPSPAD
DARBS	BRAD	DARBSBRAD
DARE	RAD	DARERAD
DARER	AD	DARERAD
DARK	RAD	DARKRAD
DARN	RAD	DARNRAD
DART	RAD	DARTRAD
DASH	SAD	DASHSAD
DATA	TAD	DATATAD
DATE	TAD	DATETAD
DATO	TAD	DATOTAD
DAW	AD	DAWAD
DAWK	WAD	DAWKWAD
DAWN	WAD	DAWNWAD
DAWS	WAD	DAWSWAD
DAWT	WAD	DAWTWAD
DAY	AD	DAYAD
DAYLILY	AD	DAYLILYAD
DEB	ED	DEBED
DEBAG	ABED	DEBAGABED
DEBAR	ABED	DEBARABED
DEBASE	SABED	DEBASESABED
DEBASES	ABED	DEBASESABED
DEBS	BED	DEBSBED
DEBT	BED	DEBTBED
DEBUTS	TUBED	DEBUTSTUBED
DECAF	ACED	DECAFACED
DECAFS	FACED	DECAFSFACED
DECAL	ACED	DECALACED
DECALS	LACED	DECALSLACED
DECAMP	MACED	DECAMPMACED
DECARE	RACED	DECARERACED
DECAY	ACED	DECAYACED
DECIDE	DICED	DECIDEDICED
DECIDED	ICED	DECIDEDICED
DEE	ED	DEEED
DEEDS	DEED	DEEDSDEED
DEEDY	DEED	DEEDYDEED
DEEPS	PEED	DEEPSPEED
DEERS	REED	DEERSREED
DEETS	TEED	DEETSTEED
DEF	ED	DEFED
DEFERRER	REFED	DEFERRERREFED
DEFERS	REFED	DEFERSREFED
DEFI	FED	DEFIFED
DEFT	FED	DEFTFED
DEGAMIS	IMAGED	DEGAMISIMAGED
DEGAS	AGED	DEGASAGED
DEGASES	AGED	DEGASESAGED
DEIFIERS	REIFIED	DEIFIERSREIFIED
DEILS	LIED	DEILSLIED
DEITY	TIED	DEITYTIED
DEKED	EKED	DEKEDEKED
DEKES	EKED	DEKESEKED
DEL	ED	DELED
DELE	LED	DELELED
DELETE	LED	DELETELED
DELF	LED	DELFLED
DELFS	FLED	DELFSFLED
DELI	LED	DELILED
DELL	ED	DELLED
DELL	LED	DELLLED
DELS	LED	DELSLED
DELT	LED	DELTLED
DEMANDED	NAMED	DEMANDEDNAMED
DEME	MED	DEMEMED
DEMITS	TIMED	DEMITSTIMED
DEMO	MED	DEMOMED
DEMODE	DOMED	DEMODEDOMED
DEMY	MED	DEMYMED
DEN	ED	DENED
DENIERS	REINED	DENIERSREINED
DENIMS	MINED	DENIMSMINED
DENOTE	TONED	DENOTETONED
DENSE	SNED	DENSESNED
DEPORT	ROPED	DEPORTROPED
DEPOSES	OPED	DEPOSESOPED
DEPOT	OPED	DEPOTOPED
DEPOTS	TOPED	DEPOTSTOPED
DERATE	TARED	DERATETARED
DERATS	TARED	DERATSTARED
DERBY	BRED	DERBYBRED
DERE	RED	DERERED
DERIDED	IRED	DERIDEDIRED
DERM	RED	DERMRED
DESEXES	ED	DESEXESED
DESKS	ED	DESKSED
DESSERTS	TRESSED	DESSERTSTRESSED
DEV	ED	DEVED
DEVILS	LIVED	DEVILSLIVED
DEW	ED	DEWED
DEWAN	AWED	DEWANAWED
DEWAR	AWED	DEWARAWED
DEWAX	AWED	DEWAXAWED
DEWORM	ROWED	DEWORMROWED
DEWS	WED	DEWSWED
DEWY	WED	DEWYWED
DEX	ED	DEXED
DEY	ED	DEYED
DIACIDIC	AID	DIACIDICAID
DIADEMED	AID	DIADEMEDAID
DIAL	AID	DIALAID
DIALERS	RELAID	DIALERSRELAID
DIALLEL	LAID	DIALLELLAID
DIALS	LAID	DIALSLAID
DIAPERS	REPAID	DIAPERSREPAID
DIB	ID	DIBID
DIBS	BID	DIBSBID
DICASTS	ACID	DICASTSACID
DID	ID	DIDID
DIDO	DID	DIDODID
DIDY	DID	DIDYDID
DIE	ID	DIEID
DIENE	ID	DIENEID
DIF	ID	DIFID
DIFF	ID	DIFFID
DIFF	FID	DIFFFID
DIFS	FID	DIFSFID
DIG	ID	DIGID
DIGAMMA	GID	DIGAMMAGID
DIGS	GID	DIGSGID
DIKE	KID	DIKEKID
DIKTAT	KID	DIKTATKID
DILL	ID	DILLID
DILL	LID	DILLLID
DIM	ID	DIMID
DIME	MID	DIMEMID
DIMITY	TIMID	DIMITYTIMID
DIMS	MID	DIMSMID
DIN	ID	DINID
DINARS	RANID	DINARSRANID
DIOLS	LOID	DIOLSLOID
DIP	ID	DIPID
DIRE	RID	DIRERID
DIRER	ID	DIRERID
DIRK	RID	DIRKRID
DIRL	RID	DIRLRID
DIRT	RID	DIRTRID
DIS	ID	DISID
DISCS	ID	DISCSID
DISKS	ID	DISKSID
DISS	ID	DISSID
DIT	ID	DITID
DIVAN	AVID	DIVANAVID
DIVAS	AVID	DIVASAVID
DIVE	VID	DIVEVID
DOC	OD	DOCOD
DOCK	COD	DOCKCOD
DOCS	COD	DOCSCOD
DOE	OD	DOEOD
DOFF	OD	DOFFOD
DOG	OD	DOGOD
DOGE	GOD	DOGEGOD
DOL	OD	DOLOD
DOLCE	CLOD	DOLCECLOD
DOLCI	CLOD	DOLCICLOD
DOLL	OD	DOLLOD
DOLLAR	ALLOD	DOLLARALLOD
DOM	OD	DOMOD
DON	OD	DONOD
DONA	NOD	DONANOD
DONE	NOD	DONENOD
DONEE	NOD	DONEENOD
DONG	NOD	DONGNOD
DONS	NOD	DONSNOD
DOOMS	MOOD	DOOMSMOOD
DOOMY	MOOD	DOOMYMOOD
DOORS	ROOD	DOORSROOD
DOPA	POD	DOPAPOD
DOPAS	APOD	DOPASAPOD
DOPE	POD	DOPEPOD
DOPY	POD	DOPYPOD
DOR	OD	DOROD
DORE	ROD	DOREROD
DORK	ROD	DORKROD
DORM	ROD	DORMROD
DORMINS	NIMROD	DORMINSNIMROD
DORP	ROD	DORPROD
DORR	OD	DORROD
DORR	ROD	DORRROD
DORS	ROD	DORSROD
DORTY	TROD	DORTYTROD
DOS	OD	DOSOD
DOSE	SOD	DOSESOD
DOSERS	RESOD	DOSERSRESOD
DOSES	OD	DOSESOD
DOSS	OD	DOSSOD
DOT	OD	DOTOD
DOTE	TOD	DOTETOD
DOTH	TOD	DOTHTOD
DOTS	TOD	DOTSTOD
DOTY	TOD	DOTYTOD
DOW	OD	DOWOD
DOYENNE	YOD	DOYENNEYOD
DOYLY	OD	DOYLYOD
DRAFT	FARD	DRAFTFARD
DRAGGING	NIGGARD	DRAGGINGNIGGARD
DRAILS	LIARD	DRAILSLIARD
DRANK	NARD	DRANKNARD
DRAPE	PARD	DRAPEPARD
DRAWEE	WARD	DRAWEEWARD
DRAWERS	REWARD	DRAWERSREWARD
DRAWL	WARD	DRAWLWARD
DRAWN	WARD	DRAWNWARD
DRAWS	WARD	DRAWSWARD
DRAYS	YARD	DRAYSYARD
DRIBS	BIRD	DRIBSBIRD
DROWN	WORD	DROWNWORD
DROWSES	WORD	DROWSESWORD
DROWSY	SWORD	DROWSYSWORD
DRUG	URD	DRUGURD
DRUM	URD	DRUMURD
DRUNK	NURD	DRUNKNURD
DRUSE	SURD	DRUSESURD
DRUSES	URD	DRUSESURD
DUALS	LAUD	DUALSLAUD
DUBS	BUD	DUBSBUD
DUCE	CUD	DUCECUD
DUCI	CUD	DUCICUD
DUCK	CUD	DUCKCUD
DUCT	CUD	DUCTCUD
DUDE	DUD	DUDEDUD
DUDS	DUD	DUDSDUD
DUELS	LEUD	DUELSLEUD
DUFF	FUD	DUFFFUD
DUMA	MUD	DUMAMUD
DUMB	MUD	DUMBMUD
DUOS	OUD	DUOSOUD
DUPE	PUD	DUPEPUD
DUPS	PUD	DUPSPUD
DWELL	LEWD	DWELLLEWD
DWELT	LEWD	DWELTLEWD
EAR	AE	EARAE
EASE	SAE	EASESAE
EASES	AE	EASESAE
EAST	SAE	EASTSAE
EASTS	AE	EASTSAE
EASY	SAE	EASYSAE
EAT	AE	EATAE
EATH	TAE	EATHTAE
EATS	TAE	EATSTAE
EAU	AE	EAUAE
EDH	DE	EDHDE
EDILES	ELIDE	EDILESELIDE
EDITS	TIDE	EDITSTIDE
EDS	DE	EDSDE
EELS	LEE	EELSLEE
EELY	LEE	EELYLEE
EERY	REE	EERYREE
EFF	FE	EFFFE
EFS	FE	EFSFE
EFT	FE	EFTFE
EGAL	AGE	EGALAGE
EGRESSES	SERGE	EGRESSESSERGE
EIGHTH	GIE	EIGHTHGIE
EKED	EKE	EKEDEKE
EKES	EKE	EKESEKE
EKUELE	UKE	EKUELEUKE
ELAN	ALE	ELANALE
ELATE	TALE	ELATETALE
ELIDED	EDILE	ELIDEDEDILE
ELIDES	EDILE	ELIDESEDILE
EME	ME	EMEME
EMES	EME	EMESEME
EMESES	EME	EMESESEME
EMESIS	EME	EMESISEME
EMEU	EME	EMEUEME
EMIRS	RIME	EMIRSRIME
EMITS	TIME	EMITSTIME
EMS	ME	EMSME
EMU	ME	EMUME
END	NE	ENDNE
ENDED	NE	ENDEDNE
ENDOPOD	NE	ENDOPODNE
ENG	NE	ENGNE
ENOL	ONE	ENOLONE
ENOLASES	ALONE	ENOLASESALONE
ENOLS	LONE	ENOLSLONE
ENOSIS	ONE	ENOSISONE
ENOW	ONE	ENOWONE
ENROBE	BORNE	ENROBEBORNE
ENS	NE	ENSNE
ENURE	RUNE	ENURERUNE
EON	OE	EONOE
EPEE	PE	EPEEPE
EPHAH	PE	EPHAHPE
EPOPEE	POPE	EPOPEEPOPE
EPOS	OPE	EPOSOPE
EPOSES	OPE	EPOSESOPE
ERA	RE	ERARE
ERAS	ARE	ERASARE
ERASES	ARE	ERASESARE
ERE	RE	ERERE
ERG	RE	ERGRE
ERGOT	OGRE	ERGOTOGRE
ERN	RE	ERNRE
ERODE	DORE	ERODEDORE
ERODED	ORE	ERODEDORE
EROS	ORE	EROSORE
EROSE	SORE	EROSESORE
EROSES	ORE	EROSESORE
ERR	RE	ERRRE
ERRATA	TARRE	ERRATATARRE
ERROR	RE	ERRORRE
ERS	RE	ERSRE
ERSES	RE	ERSESRE
ERVILS	LIVRE	ERVILSLIVRE
ETAS	ATE	ETASATE
ETNAS	ANTE	ETNASANTE
ETUI	UTE	ETUIUTE
EURIPI	RUE	EURIPIRUE
EURO	RUE	EURORUE
EVADED	AVE	EVADEDAVE
EVEN	EVE	EVENEVE
EVENS	NEVE	EVENSNEVE
EVENT	NEVE	EVENTNEVE
EVER	EVE	EVEREVE
EVES	EVE	EVESEVE
EVILS	LIVE	EVILSLIVE
EWE	WE	EWEWE
EWER	EWE	EWEREWE
EWES	EWE	EWESEWE
EXAM	AXE	EXAMAXE
EXINE	NIXE	EXINENIXE
EXING	NIXE	EXINGNIXE
EXULT	LUXE	EXULTLUXE
EYE	YE	EYEYE
EYED	EYE	EYEDEYE
EYEN	EYE	EYENEYE
EYER	EYE	EYEREYE
EYES	EYE	EYESEYE
EYRIR	YE	EYRIRYE
FAKE	KAF	FAKEKAF
FED	EF	FEDEF
FEDEXED	EF	FEDEXEDEF
FEDS	DEF	FEDSDEF
FEE	EF	FEEEF
FEEZE	EF	FEEZEEF
FEH	EF	FEHEF
FELL	EF	FELLEF
FEM	EF	FEMEF
FEN	EF	FENEF
FER	EF	FEREF
FERE	REF	FEREREF
FERN	REF	FERNREF
FERRETER	REF	FERRETERREF
FES	EF	FESEF
FESS	EF	FESSEF
FESTS	EF	FESTSEF
FET	EF	FETEF
FEU	EF	FEUEF
FEW	EF	FEWEF
FEY	EF	FEYEF
FEYLY	EF	FEYLYEF
FEZ	EF	FEZEF
FIB	IF	FIBIF
FID	IF	FIDIF
FIDO	DIF	FIDODIF
FIDS	DIF	FIDSDIF
FIE	IF	FIEIF
FIEND	NEIF	FIENDNEIF
FIG	IF	FIGIF
FIL	IF	FILIF
FILAR	ALIF	FILARALIF
FILL	IF	FILLIF
FIN	IF	FINIF
FINIKIN	IF	FINIKINIF
FIR	IF	FIRIF
FIRE	RIF	FIRERIF
FIRER	IF	FIRERIF
FIRM	RIF	FIRMRIF
FIRN	RIF	FIRNRIF
FIRS	RIF	FIRSRIF
FIRSTS	RIF	FIRSTSRIF
FISCS	IF	FISCSIF
FISTS	IF	FISTSIF
FIT	IF	FITIF
FIX	IF	FIXIF
FIZ	IF	FIZIF
FIZZ	IF	FIZZIF
FLACK	CALF	FLACKCALF
FLEA	ELF	FLEAELF
FLED	ELF	FLEDELF
FLEE	ELF	FLEEELF
FLEECE	ELF	FLEECEELF
FLEW	ELF	FLEWELF
FLEX	ELF	FLEXELF
FLEY	ELF	FLEYELF
FLORA	ROLF	FLORAROLF
FLOWN	WOLF	FLOWNWOLF
FLOWS	WOLF	FLOWSWOLF
FOB	OF	FOBOF
FOE	OF	FOEOF
FOG	OF	FOGOF
FOH	OF	FOHOF
FON	OF	FONOF
FOOLS	LOOF	FOOLSLOOF
FOP	OF	FOPOF
FOR	OF	FOROF
FOREVER	OF	FOREVEROF
FOSS	OF	FOSSOF
FOU	OF	FOUOF
FOX	OF	FOXOF
FOY	OF	FOYOF
FRAE	ARF	FRAEARF
FRAG	ARF	FRAGARF
FRAP	ARF	FRAPARF
FRASS	ARF	FRASSARF
FRAT	ARF	FRATARF
FRAY	ARF	FRAYARF
FRESH	SERF	FRESHSERF
FRESNEL	ENSERF	FRESNELENSERF
FROCK	CORF	FROCKCORF
GAB	AG	GABAG
GABELLE	BAG	GABELLEBAG
GABS	BAG	GABSBAG
GABY	BAG	GABYBAG
GAD	AG	GADAG
GADDED	DAG	GADDEDDAG
GADI	DAG	GADIDAG
GADID	AG	GADIDAG
GADS	DAG	GADSDAG
GAE	AG	GAEAG
GAFF	AG	GAFFAG
GAFF	FAG	GAFFFAG
GAG	AG	GAGAG
GAGA	GAG	GAGAGAG
GAGE	GAG	GAGEGAG
GAGS	GAG	GAGSGAG
GAL	AG	GALAG
GALA	LAG	GALALAG
GALE	LAG	GALELAG
GALEAE	LAG	GALEAELAG
GALERE	LAG	GALERELAG
GALETTE	LAG	GALETTELAG
GALL	AG	GALLAG
GALL	LAG	GALLLAG
GALS	LAG	GALSLAG
GAM	AG	GAMAG
GAMA	MAG	GAMAMAG
GAN	AG	GANAG
GANDERED	NAG	GANDEREDNAG
GANE	NAG	GANENAG
GANG	NAG	GANGNAG
GAP	AG	GAPAG
GAR	AG	GARAG
GARB	RAG	GARBRAG
GARBS	BRAG	GARBSBRAG
GARDENED	RAG	GARDENEDRAG
GARS	RAG	GARSRAG
GAS	AG	GASAG
GASEITIES	AG	GASEITIESAG
GASES	AG	GASESAG
GASH	SAG	GASHSAG
GASPS	AG	GASPSAG
GASTS	AG	GASTSAG
GAT	AG	GATAG
GATE	TAG	GATETAG
GATERS	RETAG	GATERSRETAG
GATS	TAG	GATSTAG
GAWK	WAG	GAWKWAG
GAWP	WAG	GAWPWAG
GAWSY	SWAG	GAWSYSWAG
GAY	AG	GAYAG
GAYLY	AG	GAYLYAG
GAZE	ZAG	GAZEZAG
GAZELLE	ZAG	GAZELLEZAG
GAZETTE	ZAG	GAZETTEZAG
GELADA	LEG	GELADALEG
GELD	LEG	GELDLEG
GELDED	LEG	GELDEDLEG
GELDERS	REDLEG	GELDERSREDLEG
GELEE	LEG	GELEELEG
GELS	LEG	GELSLEG
GELT	LEG	GELTLEG
GEMS	MEG	GEMSMEG
GERM	REG	GERMREG
GETA	TEG	GETATEG
GETS	TEG	GETSTEG
GIBE	BIG	GIBEBIG
GIBS	BIG	GIBSBIG
GIDS	DIG	GIDSDIG
GIFT	FIG	GIFTFIG
GIGA	GIG	GIGAGIG
GIGOLO	GIG	GIGOLOGIG
GIGS	GIG	GIGSGIG
GIMP	MIG	GIMPMIG
GIRD	RIG	GIRDRIG
GIRDED	RIG	GIRDEDRIG
GIRL	RIG	GIRLRIG
GIRN	RIG	GIRNRIG
GIRO	RIG	GIRORIG
GIRT	RIG	GIRTRIG
GIRTH	TRIG	GIRTHTRIG
GIRTS	TRIG	GIRTSTRIG
GIVE	VIG	GIVEVIG
GNARL	RANG	GNARLRANG
GNARR	RANG	GNARRRANG
GNARS	RANG	GNARSRANG
GNATS	TANG	GNATSTANG
GODDED	DOG	GODDEDDOG
GODS	DOG	GODSDOG
GOLD	LOG	GOLDLOG
GOLF	LOG	GOLFLOG
GOLFS	FLOG	GOLFSFLOG
GONE	NOG	GONENOG
GONG	NOG	GONGNOG
GORPS	PROG	GORPSPROG
GOTH	TOG	GOTHTOG
GOWD	WOG	GOWDWOG
GOWK	WOG	GOWKWOG
GOWN	WOG	GOWNWOG
GREBE	BERG	GREBEBERG
GREE	ERG	GREEERG
GREW	ERG	GREWERG
GREY	ERG	GREYERG
GREYLY	ERG	GREYLYERG
GRUBS	BURG	GRUBSBURG
GUDE	DUG	GUDEDUG
GUFF	FUG	GUFFFUG
GULF	LUG	GULFLUG
GULL	LUG	GULLLUG
GULP	LUG	GULPLUG
GULPS	PLUG	GULPSPLUG
GULS	LUG	GULSLUG
GUMS	MUG	GUMSMUG
GURU	RUG	GURURUG
GUVS	VUG	GUVSVUG
HAAF	AAH	HAAFAAH
HABOOB	AH	HABOOBAH
HABU	BAH	HABUBAH
HAD	AH	HADAH
HADE	DAH	HADEDAH
HADED	AH	HADEDAH
HADJ	DAH	HADJDAH
HAE	AH	HAEAH
HAG	AH	HAGAH
HAH	AH	HAHAH
HAHA	HAH	HAHAHAH
HAHS	HAH	HAHSHAH
HAJ	AH	HAJAH
HAJJ	AH	HAJJAH
HALAL	AH	HALALAH
HALALAHS	HALALAH	HALALAHSHALALAH
HALEST	SELAH	HALESTSELAH
HALL	AH	HALLAH
HALLAHS	HALLAH	HALLAHSHALLAH
HAM	AH	HAMAH
HAMAL	AMAH	HAMALAMAH
HAND	NAH	HANDNAH
HANDED	NAH	HANDEDNAH
HANG	NAH	HANGNAH
HANK	NAH	HANKNAH
HANSAS	NAH	HANSASNAH
HANSES	NAH	HANSESNAH
HANT	NAH	HANTNAH
HAO	AH	HAOAH
HAP	AH	HAPAH
HAPS	PAH	HAPSPAH
HARD	RAH	HARDRAH
HARDENED	RAH	HARDENEDRAH
HARE	RAH	HARERAH
HARK	RAH	HARKRAH
HARL	RAH	HARLRAH
HARM	RAH	HARMRAH
HARP	RAH	HARPRAH
HART	RAH	HARTRAH
HAS	AH	HASAH
HASPS	AH	HASPSAH
HAT	AH	HATAH
HAW	AH	HAWAH
HAY	AH	HAYAH
HAYEY	AH	HAYEYAH
HAYS	YAH	HAYSYAH
HEEZE	EH	HEEZEEH
HEFT	FEH	HEFTFEH
HEH	EH	HEHEH
HEHS	HEH	HEHSHEH
HELL	EH	HELLEH
HEM	EH	HEMEH
HEN	EH	HENEH
HEP	EH	HEPEH
HER	EH	HEREH
HES	EH	HESEH
HESTS	EH	HESTSEH
HET	EH	HETEH
HEW	EH	HEWEH
HEX	EH	HEXEH
HEY	EH	HEYEH
HOB	OH	HOBOH
HOD	OH	HODOH
HODAD	OH	HODADOH
HOE	OH	HOEOH
HOG	OH	HOGOH
HOGG	OH	HOGGOH
HON	OH	HONOH
HONAN	OH	HONANOH
HOOD	OOH	HOODOOH
HOODED	OOH	HOODEDOOH
HOOF	OOH	HOOFOOH
HOOK	OOH	HOOKOOH
HOOP	OOH	HOOPOOH
HOP	OH	HOPOH
HOPE	POH	HOPEPOH
HOPS	POH	HOPSPOH
HOS	OH	HOSOH
HOSANNAS	OH	HOSANNASOH
HOSEPIPES	OH	HOSEPIPESOH
HOSES	OH	HOSESOH
HOSTS	OH	HOSTSOH
HOT	OH	HOTOH
HOW	OH	HOWOH
HOY	OH	HOYOH
HUB	UH	HUBUH
HUE	UH	HUEUH
HUFF	UH	HUFFUH
HUG	UH	HUGUH
HUH	UH	HUHUH
HULL	UH	HULLUH
HUM	UH	HUMUH
HUN	UH	HUNUH
HUP	UH	HUPUH
HUSKS	UH	HUSKSUH
HUT	UH	HUTUH
ILK	LI	ILKLI
ILL	LI	ILLLI
IMAM	AMI	IMAMAMI
IMP	MI	IMPMI
INARM	RANI	INARMRANI
INGEST	SEGNI	INGESTSEGNI
IODID	OI	IODIDOI
ION	OI	IONOI
IRONE	NORI	IRONENORI
IRONS	NORI	IRONSNORI
IRONY	NORI	IRONYNORI
ISM	SI	ISMSI
ITS	TI	ITSTI
JATO	TAJ	JATOTAJ
KADI	DAK	KADIDAK
KAIAKS	KAIAK	KAIAKSKAIAK
KAON	OAK	KAONOAK
KARAT	ARAK	KARATARAK
KAYO	YAK	KAYOYAK
KAYS	YAK	KAYSYAK
KEEF	EEK	KEEFEEK
KEEK	EEK	KEEKEEK
KEEL	EEK	KEELEEK
KEELS	LEEK	KEELSLEEK
KEEN	EEK	KEENEEK
KEEP	EEK	KEEPEEK
KEET	EEK	KEETEEK
KELP	LEK	KELPLEK
KELT	LEK	KELTLEK
KLIK	ILK	KLIKILK
KNARS	RANK	KNARSRANK
KNAWE	WANK	KNAWEWANK
KNIT	INK	KNITINK
KNOCK	CONK	KNOCKCONK
KORATS	TAROK	KORATSTAROK
KRIS	IRK	KRISIRK
KRISES	IRK	KRISESIRK
KUSSOS	SUK	KUSSOSSUK
LAB	AL	LABAL
LABARA	BAL	LABARABAL
LABS	BAL	LABSBAL
LAC	AL	LACAL
LAD	AL	LADAL
LADDERED	DAL	LADDEREDDAL
LADE	DAL	LADEDAL
LADED	AL	LADEDAL
LADENED	AL	LADENEDAL
LADINO	NIDAL	LADINONIDAL
LADS	DAL	LADSDAL
LADY	DAL	LADYDAL
LAG	AL	LAGAL
LAGER	EGAL	LAGEREGAL
LAGERS	REGAL	LAGERSREGAL
LAGS	GAL	LAGSGAL
LAIRD	RIAL	LAIRDRIAL
LAIRS	RIAL	LAIRSRIAL
LALL	AL	LALLAL
LAM	AL	LAMAL
LAMINAE	ANIMAL	LAMINAEANIMAL
LAMINAL	ANIMAL	LAMINALANIMAL
LAMINAR	ANIMAL	LAMINARANIMAL
LAMINAS	ANIMAL	LAMINASANIMAL
LAP	AL	LAPAL
LAPILLI	PAL	LAPILLIPAL
LAPS	PAL	LAPSPAL
LAPSES	PAL	LAPSESPAL
LAPSUS	PAL	LAPSUSPAL
LAR	AL	LARAL
LARUMS	MURAL	LARUMSMURAL
LAS	AL	LASAL
LASE	SAL	LASESAL
LASES	AL	LASESAL
LASH	SAL	LASHSAL
LASS	AL	LASSAL
LASS	SAL	LASSSAL
LASSES	SAL	LASSESSAL
LASSIS	SAL	LASSISSAL
LASSOS	SAL	LASSOSSAL
LAST	SAL	LASTSAL
LASTS	AL	LASTSAL
LAT	AL	LATAL
LATEST	SETAL	LATESTSETAL
LAUDS	DUAL	LAUDSDUAL
LAV	AL	LAVAL
LAW	AL	LAWAL
LAX	AL	LAXAL
LAY	AL	LAYAL
LAYAWAY	AL	LAYAWAYAL
LED	EL	LEDEL
LEE	EL	LEEEL
LEEK	EEL	LEEKEEL
LEEKS	KEEL	LEEKSKEEL
LEER	EEL	LEEREEL
LEERS	REEL	LEERSREEL
LEERY	REEL	LEERYREEL
LEES	EEL	LEESEEL
LEET	EEL	LEETEEL
LEETS	TEEL	LEETSTEEL
LEG	EL	LEGEL
LEGS	GEL	LEGSGEL
LEI	EL	LEIEL
LEK	EL	LEKEL
LEPERS	REPEL	LEPERSREPEL
LES	EL	LESEL
LESES	EL	LESESEL
LESS	EL	LESSEL
LESS	SEL	LESSSEL
LESSEES	SEL	LESSEESSEL
LEST	SEL	LESTSEL
LET	EL	LETEL
LETS	TEL	LETSTEL
LEU	EL	LEUEL
LEUDS	DUEL	LEUDSDUEL
LEV	EL	LEVEL
LEVELS	LEVEL	LEVELSLEVEL
LEVERS	REVEL	LEVERSREVEL
LEX	EL	LEXEL
LEY	EL	LEYEL
LEZ	EL	LEZEL
LIANE	NAIL	LIANENAIL
LIANG	NAIL	LIANGNAIL
LIAR	AIL	LIARAIL
LIARD	RAIL	LIARDRAIL
LIARDS	DRAIL	LIARDSDRAIL
LIARS	RAIL	LIARSRAIL
LIEVE	VEIL	LIEVEVEIL
LIFT	FIL	LIFTFIL
LIMA	MIL	LIMAMIL
LIMB	MIL	LIMBMIL
LIME	MIL	LIMEMIL
LIMN	MIL	LIMNMIL
LIMO	MIL	LIMOMIL
LIMP	MIL	LIMPMIL
LION	OIL	LIONOIL
LIONS	NOIL	LIONSNOIL
LIRAS	ARIL	LIRASARIL
LITE	TIL	LITETIL
LITS	TIL	LITSTIL
LITU	TIL	LITUTIL
LIVED	EVIL	LIVEDEVIL
LIVEN	EVIL	LIVENEVIL
LIVER	EVIL	LIVEREVIL
LIVES	EVIL	LIVESEVIL
LIVRES	ERVIL	LIVRESERVIL
LOBOS	OBOL	LOBOSOBOL
LOCA	COL	LOCACOL
LOCH	COL	LOCHCOL
LOCI	COL	LOCICOL
LOCK	COL	LOCKCOL
LOCO	COL	LOCOCOL
LOIDS	DIOL	LOIDSDIOL
LONER	ENOL	LONERENOL
LOOFA	FOOL	LOOFAFOOL
LOOFS	FOOL	LOOFSFOOL
LOOMS	MOOL	LOOMSMOOL
LOOPS	POOL	LOOPSPOOL
LOOPY	POOL	LOOPYPOOL
LOOTERS	RETOOL	LOOTERSRETOOL
LOOTS	TOOL	LOOTSTOOL
LOPE	POL	LOPEPOL
LOPS	POL	LOPSPOL
LOSE	SOL	LOSESOL
LOSS	SOL	LOSSSOL
LOSSES	SOL	LOSSESSOL
LOST	SOL	LOSTSOL
LUGE	GUL	LUGEGUL
LUGS	GUL	LUGSGUL
MABE	BAM	MABEBAM
MAC	AM	MACAM
MACE	CAM	MACECAM
MACH	CAM	MACHCAM
MACK	CAM	MACKCAM
MACS	CAM	MACSCAM
MAD	AM	MADAM
MADAME	MADAM	MADAMEMADAM
MADAMS	MADAM	MADAMSMADAM
MADDED	DAM	MADDEDDAM
MADDENED	DAM	MADDENEDDAM
MADE	DAM	MADEDAM
MADS	DAM	MADSDAM
MAE	AM	MAEAM
MAG	AM	MAGAM
MAGE	GAM	MAGEGAM
MAGI	GAM	MAGIGAM
MAGOT	OGAM	MAGOTOGAM
MALACCA	LAM	MALACCALAM
MALE	LAM	MALELAM
MALL	AM	MALLAM
MALL	LAM	MALLLAM
MALM	LAM	MALMLAM
MALT	LAM	MALTLAM
MAMIE	IMAM	MAMIEIMAM
AM	MAMMA	AMMAMMA
LAM	MAMMAL	LAMMAMMAL
MAN	AM	MANAM
MANA	NAM	MANANAM
MANANA	NAM	MANANANAM
MANE	NAM	MANENAM
MANEGE	NAM	MANEGENAM
MANIKIN	AM	MANIKINAM
MANNAN	NAM	MANNANNAM
MANNIKIN	NAM	MANNIKINNAM
MANO	NAM	MANONAM
MANS	NAM	MANSNAM
MANSES	NAM	MANSESNAM
MANTELET	NAM	MANTELETNAM
MANY	NAM	MANYNAM
MAP	AM	MAPAM
MAPS	PAM	MAPSPAM
MAR	AM	MARAM
MARA	RAM	MARARAM
MARACA	RAM	MARACARAM
MARC	RAM	MARCRAM
MARCH	CRAM	MARCHCRAM
MARCS	CRAM	MARCSCRAM
MARE	RAM	MARERAM
MAREMME	RAM	MAREMMERAM
MARGE	GRAM	MARGEGRAM
MARK	RAM	MARKRAM
MARL	RAM	MARLRAM
MARRAMS	MARRAM	MARRAMSMARRAM
MARRER	RAM	MARRERRAM
MARS	RAM	MARSRAM
MARSALAS	RAM	MARSALASRAM
MARSES	RAM	MARSESRAM
MART	RAM	MARTRAM
MARTINI	TRAM	MARTINITRAM
MARTS	TRAM	MARTSTRAM
MARTYRY	TRAM	MARTYRYTRAM
MAS	AM	MASAM
MASALAS	AM	MASALASAM
MASAS	AM	MASASAM
MASKS	AM	MASKSAM
MASS	AM	MASSAM
MASTS	AM	MASTSAM
MAT	AM	MATAM
MATE	TAM	MATETAM
MATH	TAM	MATHTAM
MATS	TAM	MATSTAM
MATT	AM	MATTAM
MATT	TAM	MATTTAM
MAW	AM	MAWAM
MAX	AM	MAXAM
MAXED	EXAM	MAXEDEXAM
MAY	AM	MAYAM
MAYA	YAM	MAYAYAM
MAYO	YAM	MAYOYAM
MAYPOP	YAM	MAYPOPYAM
MAYS	YAM	MAYSYAM
MED	EM	MEDEM
MEDIA	IDEM	MEDIAIDEM
MEDIC	IDEM	MEDICIDEM
MEDII	IDEM	MEDIIIDEM
MEEDS	DEEM	MEEDSDEEM
MEETS	TEEM	MEETSTEEM
MEG	EM	MEGEM
MEGA	GEM	MEGAGEM
MEGARA	GEM	MEGARAGEM
MEL	EM	MELEM
MELL	EM	MELLEM
MEM	EM	MEMEM
MEME	MEM	MEMEMEM
MEMO	MEM	MEMOMEM
MEMS	MEM	MEMSMEM
MEN	EM	MENEM
MERC	REM	MERCREM
MERE	REM	MEREREM
MERER	EM	MEREREM
MERK	REM	MERKREM
MERL	REM	MERLREM
MESAS	EM	MESASEM
MESS	EM	MESSEM
MET	EM	METEM
METIS	ITEM	METISITEM
MEW	EM	MEWEM
MHOS	OHM	MHOSOHM
MIASMS	AIM	MIASMSAIM
MIDI	DIM	MIDIDIM
MIDNOON	DIM	MIDNOONDIM
MIDS	DIM	MIDSDIM
MIDSTS	DIM	MIDSTSDIM
MIME	MIM	MIMEMIM
MIMETITE	MIM	MIMETITEMIM
MIND	NIM	MINDNIM
MINDED	NIM	MINDEDNIM
MINE	NIM	MINENIM
MINI	NIM	MININIM
MINIMA	MINIM	MINIMAMINIM
MINIMS	MINIM	MINIMSMINIM
MINK	NIM	MINKNIM
MINT	NIM	MINTNIM
MINX	NIM	MINXNIM
MIRE	RIM	MIRERIM
MIRI	RIM	MIRIRIM
MIRK	RIM	MIRKRIM
MIRROR	RIM	MIRRORRIM
MIRS	RIM	MIRSRIM
MIRTH	TRIM	MIRTHTRIM
MIRY	RIM	MIRYRIM
MISDEED	SIM	MISDEEDSIM
MISDID	SIM	MISDIDSIM
MISE	SIM	MISESIM
MISERERE	SIM	MISERERESIM
MISO	SIM	MISOSIM
MISREFER	SIM	MISREFERSIM
MISS	SIM	MISSSIM
MISSES	SIM	MISSESSIM
MISSIS	SIM	MISSISSIM
MISSUS	SIM	MISSUSSIM
MIST	SIM	MISTSIM
MOA	OM	MOAOM
MOB	OM	MOBOM
MOC	OM	MOCOM
MOD	OM	MODOM
MODE	DOM	MODEDOM
MODELED	OM	MODELEDOM
MODELLED	OM	MODELLEDOM
MODEMED	OM	MODEMEDOM
MODI	DOM	MODIDOM
MODS	DOM	MODSDOM
MOG	OM	MOGOM
MOL	OM	MOLOM
MOLAL	OM	MOLALOM
MOLL	OM	MOLLOM
MOM	OM	MOMOM
MOME	MOM	MOMEMOM
MOMI	MOM	MOMIMOM
MOMS	MOM	MOMSMOM
MON	OM	MONOM
MONK	NOM	MONKNOM
MONO	NOM	MONONOM
MONS	NOM	MONSNOM
MONY	NOM	MONYNOM
MOO	OM	MOOOM
MOOLA	LOOM	MOOLALOOM
MOOLS	LOOM	MOOLSLOOM
MOORS	ROOM	MOORSROOM
MOORY	ROOM	MOORYROOM
MOP	OM	MOPOM
MOPE	POM	MOPEPOM
MOR	OM	MOROM
MORA	ROM	MORAROM
MORE	ROM	MOREROM
MORELLE	ROM	MORELLEROM
MORN	ROM	MORNROM
MOROCCO	ROM	MOROCCOROM
MORPH	PROM	MORPHPROM
MORS	ROM	MORSROM
MORT	ROM	MORTROM
MOS	OM	MOSOM
MOSH	SOM	MOSHSOM
MOSK	SOM	MOSKSOM
MOSKS	OM	MOSKSOM
MOSS	OM	MOSSOM
MOSS	SOM	MOSSSOM
MOSSES	SOM	MOSSESSOM
MOST	SOM	MOSTSOM
MOSTS	OM	MOSTSOM
MOT	OM	MOTOM
MOTE	TOM	MOTETOM
MOTET	OM	MOTETOM
MOTH	TOM	MOTHTOM
MOTS	TOM	MOTSTOM
MOTT	OM	MOTTOM
MOTT	TOM	MOTTTOM
MOW	OM	MOWOM
MUCK	CUM	MUCKCUM
MUD	UM	MUDUM
MUFF	UM	MUFFUM
MUG	UM	MUGUM
MUGG	UM	MUGGUM
MUGG	GUM	MUGGGUM
MUGS	GUM	MUGSGUM
MULE	LUM	MULELUM
MULL	UM	MULLUM
MULL	LUM	MULLLUM
MUM	UM	MUMUM
MUMM	UM	MUMMUM
MUMM	MUM	MUMMMUM
MUMP	MUM	MUMPMUM
MUMS	MUM	MUMSMUM
MUMU	MUM	MUMUMUM
MUN	UM	MUNUM
MURAL	ARUM	MURALARUM
MURALS	LARUM	MURALSLARUM
MURAS	ARUM	MURASARUM
MURDERED	RUM	MURDEREDRUM
MURE	RUM	MURERUM
MURK	RUM	MURKRUM
MURR	UM	MURRUM
MURR	RUM	MURRRUM
MUS	UM	MUSUM
MUSE	SUM	MUSESUM
MUSES	UM	MUSESUM
MUSETTE	SUM	MUSETTESUM
MUSETTES	UM	MUSETTESUM
MUSH	SUM	MUSHSUM
MUSK	SUM	MUSKSUM
MUSKS	UM	MUSKSUM
MUSS	UM	MUSSUM
MUSS	SUM	MUSSSUM
MUSSES	SUM	MUSSESSUM
MUST	SUM	MUSTSUM
MUSTS	UM	MUSTSUM
MUT	UM	MUTUM
MUTONS	NOTUM	MUTONSNOTUM
MUTT	UM	MUTTUM
NAANS	NAAN	NAANSNAAN
NAB	AN	NABAN
NABE	BAN	NABEBAN
NABOB	AN	NABOBAN
NABS	BAN	NABSBAN
NACELLE	CAN	NACELLECAN
NAE	AN	NAEAN
NAFF	AN	NAFFAN
NAG	AN	NAGAN
NAGANA	GAN	NAGANAGAN
NAGS	GAN	NAGSGAN
NAH	AN	NAHAN
NALAS	ALAN	NALASALAN
NAM	AN	NAMAN
NAME	MAN	NAMEMAN
NAMELY	LEMAN	NAMELYLEMAN
NAMERS	REMAN	NAMERSREMAN
NAMETAGS	GATEMAN	NAMETAGSGATEMAN
NAN	AN	NANAN
NANA	NAN	NANANAN
NANS	NAN	NANSNAN
NAP	AN	NAPAN
NAPA	PAN	NAPAPAN
NAPE	PAN	NAPEPAN
NAPS	PAN	NAPSPAN
NARD	RAN	NARDRAN
NARK	RAN	NARKRAN
NARY	RAN	NARYRAN
NAVE	VAN	NAVEVAN
NAVETTE	VAN	NAVETTEVAN
NAW	AN	NAWAN
NAY	AN	NAYAN
NEB	EN	NEBEN
NEE	EN	NEEEN
NEEPS	PEEN	NEEPSPEEN
NEG	EN	NEGEN
NEGS	GEN	NEGSGEN
NEIGH	GIEN	NEIGHGIEN
NEMA	MEN	NEMAMEN
NEMAS	AMEN	NEMASAMEN
NESS	EN	NESSEN
NESS	SEN	NESSSEN
NESSES	SEN	NESSESSEN
NEST	SEN	NESTSEN
NESTS	EN	NESTSEN
NET	EN	NETEN
NETS	TEN	NETSTEN
NETT	EN	NETTEN
NETT	TEN	NETTTEN
NEVER	EVEN	NEVEREVEN
NEVES	EVEN	NEVESEVEN
NEW	EN	NEWEN
NEWS	WEN	NEWSWEN
NEWT	WEN	NEWTWEN
NIB	IN	NIBIN
NIBS	BIN	NIBSBIN
NIDE	DIN	NIDEDIN
NIDED	IN	NIDEDIN
NIDI	DIN	NIDIDIN
NIECE	IN	NIECEIN
NIEVE	IN	NIEVEIN
NIGH	GIN	NIGHGIN
NIL	IN	NILIN
NILL	IN	NILLIN
NILL	LIN	NILLLIN
NILS	LIN	NILSLIN
NIM	IN	NIMIN
NIMRODS	DORMIN	NIMRODSDORMIN
NINON	IN	NINONIN
NIP	IN	NIPIN
NIPA	PIN	NIPAPIN
NIPS	PIN	NIPSPIN
NISI	SIN	NISISIN
NISUS	IN	NISUSIN
NIT	IN	NITIN
NITE	TIN	NITETIN
NITS	TIN	NITSTIN
NIX	IN	NIXIN
NOB	ON	NOBON
NOCK	CON	NOCKCON
NOD	ON	NODON
NODDED	DON	NODDEDDON
NODE	DON	NODEDON
NODI	DON	NODIDON
NODS	DON	NODSDON
NODUS	UDON	NODUSUDON
NOEL	EON	NOELEON
NOES	EON	NOESEON
NOG	ON	NOGON
NOGG	ON	NOGGON
NOH	ON	NOHON
NOILS	LION	NOILSLION
NOILY	LION	NOILYLION
NOIR	ION	NOIRION
NOISES	ION	NOISESION
NOISETTES	ION	NOISETTESION
NOM	ON	NOMON
NOMA	MON	NOMAMON
NOME	MON	NOMEMON
NOMS	MON	NOMSMON
NONACIDIC	ANON	NONACIDICANON
NONAS	ANON	NONASANON
NONETS	TENON	NONETSTENON
NOO	ON	NOOON
NOONS	NOON	NOONSNOON
NOR	ON	NORON
NORIA	IRON	NORIAIRON
NORIS	IRON	NORISIRON
NOS	ON	NOSON
NOSE	SON	NOSESON
NOSES	ON	NOSESON
NOSH	SON	NOSHSON
NOSY	SON	NOSYSON
NOT	ON	NOTON
NOTA	TON	NOTATON
NOTE	TON	NOTETON
NOW	ON	NOWON
NOWS	WON	NOWSWON
NOWT	WON	NOWTWON
NUB	UN	NUBUN
NUBS	BUN	NUBSBUN
NUDE	DUN	NUDEDUN
NULL	UN	NULLUN
NUMB	MUN	NUMBMUN
NUN	UN	NUNUN
NUNS	NUN	NUNSNUN
NURD	RUN	NURDRUN
NURL	RUN	NURLRUN
NURSES	RUN	NURSESRUN
NUS	UN	NUSUN
NUT	UN	NUTUN
NUTS	TUN	NUTSTUN
OBA	BO	OBABO
OBAS	ABO	OBASABO
OBE	BO	OBEBO
OBESE	BO	OBESEBO
OBI	BO	OBIBO
OBOLE	LOBO	OBOLELOBO
OBOLI	LOBO	OBOLILOBO
OBOLS	LOBO	OBOLSLOBO
OBSESSES	BO	OBSESSESBO
ODA	DO	ODADO
ODAH	ADO	ODAHADO
ODAS	ADO	ODASADO
ODD	DO	ODDDO
ODDER	EDDO	ODDEREDDO
ODE	DO	ODEDO
ODS	DO	ODSDO
OGEE	GO	OGEEGO
OGEE	EGO	OGEEEGO
OGRES	ERGO	OGRESERGO
OGRESS	ERGO	OGRESSERGO
OHM	HO	OHMHO
OHMS	MHO	OHMSMHO
OHO	HO	OHOHO
OHS	HO	OHSHO
OLD	LO	OLDLO
OLE	LO	OLELO
OMASA	MO	OMASAMO
OMS	MO	OMSMO
ONE	NO	ONENO
ONO	NO	ONONO
ONOS	ONO	ONOSONO
ONS	NO	ONSNO
OOPS	POO	OOPSPOO
OOTS	TOO	OOTSTOO
OPAH	APO	OPAHAPO
OPAL	APO	OPALAPO
OPUS	UPO	OPUSUPO
OPUSES	UPO	OPUSESUPO
ORATE	TARO	ORATETARO
ORBS	BRO	ORBSBRO
ORBY	BRO	ORBYBRO
OREAD	AERO	OREADAERO
ORIBI	BIRO	ORIBIBIRO
ORNIS	INRO	ORNISINRO
OSE	SO	OSESO
OTTOS	OTTO	OTTOSOTTO
OUDS	DUO	OUDSDUO
OVAL	AVO	OVALAVO
OWE	WO	OWEWO
OWL	WO	OWLWO
OWN	WO	OWNWO
PACA	CAP	PACACAP
PACE	CAP	PACECAP
PACERS	RECAP	PACERSRECAP
PACK	CAP	PACKCAP
PACS	CAP	PACSCAP
PACT	CAP	PACTCAP
PACY	CAP	PACYCAP
PADDED	DAP	PADDEDDAP
PADI	DAP	PADIDAP
PADS	DAP	PADSDAP
PADSHAHS	DAP	PADSHAHSDAP
PAGE	GAP	PAGEGAP
PALAPA	LAP	PALAPALAP
PALE	LAP	PALELAP
PALEAE	LAP	PALEAELAP
PALETTE	LAP	PALETTELAP
PALL	LAP	PALLLAP
PALM	LAP	PALMLAP
PALP	LAP	PALPLAP
PALS	LAP	PALSLAP
PALSY	SLAP	PALSYSLAP
PALY	LAP	PALYLAP
PAMS	MAP	PAMSMAP
PANADA	NAP	PANADANAP
PANAMA	NAP	PANAMANAP
PANDERED	NAP	PANDEREDNAP
PANE	NAP	PANENAP
PANG	NAP	PANGNAP
PANINI	NAP	PANININAP
PANNIKIN	NAP	PANNIKINNAP
PANS	NAP	PANSNAP
PANSY	SNAP	PANSYSNAP
PANT	NAP	PANTNAP
PAPA	PAP	PAPAPAP
PAPAYA	PAP	PAPAYAPAP
PARA	RAP	PARARAP
PARCH	CRAP	PARCHCRAP
PARD	RAP	PARDRAP
PARE	RAP	PARERAP
PAREVE	RAP	PAREVERAP
PARK	RAP	PARKRAP
PARR	RAP	PARRRAP
PARS	RAP	PARSRAP
PARSES	RAP	PARSESRAP
PART	RAP	PARTRAP
PARTERRE	TRAP	PARTERRETRAP
PARTS	TRAP	PARTSTRAP
PARTY	TRAP	PARTYTRAP
PASE	SAP	PASESAP
PATACA	TAP	PATACATAP
PATE	TAP	PATETAP
PATH	TAP	PATHTAP
PAWL	WAP	PAWLWAP
PAWN	WAP	PAWNWAP
PAWS	WAP	PAWSWAP
PECH	CEP	PECHCEP
PECK	CEP	PECKCEP
PECS	CEP	PECSCEP
PEEKS	KEEP	PEEKSKEEP
PEEPS	PEEP	PEEPSPEEP
PEEVE	VEEP	PEEVEVEEP
PEEWEE	WEEP	PEEWEEWEEP
PEHS	HEP	PEHSHEP
PEKE	KEP	PEKEKEP
REP	PEPPER	REPPEPPER
PERE	REP	PEREREP
PERI	REP	PERIREP
PERITI	REP	PERITIREP
PERK	REP	PERKREP
PERM	REP	PERMREP
PERP	REP	PERPREP
PERPS	PREP	PERPSPREP
PERSES	REP	PERSESREP
PERT	REP	PERTREP
PERV	REP	PERVREP
PIKA	KIP	PIKAKIP
PIKE	KIP	PIKEKIP
PIKI	KIP	PIKIKIP
PILE	LIP	PILELIP
PILI	LIP	PILILIP
PILL	LIP	PILLLIP
PILY	LIP	PILYLIP
PINA	NIP	PINANIP
PINATA	NIP	PINATANIP
PINE	NIP	PINENIP
PINENE	NIP	PINENENIP
PING	NIP	PINGNIP
PINK	NIP	PINKNIP
PINS	NIP	PINSNIP
PINT	NIP	PINTNIP
PIRANA	RIP	PIRANARIP
PIRAYA	RIP	PIRAYARIP
PIRN	RIP	PIRNRIP
PISH	SIP	PISHSIP
PISO	SIP	PISOSIP
PISS	SIP	PISSSIP
PISSES	SIP	PISSESSIP
PITA	TIP	PITATIP
PITAYA	TIP	PITAYATIP
PITH	TIP	PITHTIP
PITS	TIP	PITSTIP
PITY	TIP	PITYTIP
PLAN	ALP	PLANALP
PLASH	SALP	PLASHSALP
PLASMS	ALP	PLASMSALP
PLAT	ALP	PLATALP
PLATELET	ALP	PLATELETALP
PLAY	ALP	PLAYALP
POCK	COP	POCKCOP
POCO	COP	POCOCOP
POD	OP	PODOP
POH	OP	POHOP
POI	OP	POIOP
POKE	KOP	POKEKOP
POKY	KOP	POKYKOP
POL	OP	POLOP
POLE	LOP	POLELOP
POLL	OP	POLLOP
POLL	LOP	POLLLOP
POLLOCK	COLLOP	POLLOCKCOLLOP
POLO	LOP	POLOLOP
POLS	LOP	POLSLOP
POM	OP	POMOP
POME	MOP	POMEMOP
POMO	MOP	POMOMOP
POMP	MOP	POMPMOP
POMS	MOP	POMSMOP
POO	OP	POOOP
POOCH	COOP	POOCHCOOP
POOHS	HOOP	POOHSHOOP
POOLS	LOOP	POOLSLOOP
POOPS	POOP	POOPSPOOP
POP	OP	POPOP
POPE	POP	POPEPOP
POPS	POP	POPSPOP
PORCH	CROP	PORCHCROP
PORCINI	CROP	PORCINICROP
PORTS	TROP	PORTSTROP
POSADA	SOP	POSADASOP
POSADAS	OP	POSADASOP
POSE	SOP	POSESOP
POSES	OP	POSESOP
POSH	SOP	POSHSOP
POSSES	SOP	POSSESSOP
POSSESS	OP	POSSESSOP
POSSESSES	SOP	POSSESSESSOP
POST	SOP	POSTSOP
POSTS	OP	POSTSOP
POSY	SOP	POSYSOP
POT	OP	POTOP
POTENT	NETOP	POTENTNETOP
POTS	TOP	POTSTOP
POTSY	STOP	POTSYSTOP
POW	OP	POWOP
POWDERED	WOP	POWDEREDWOP
POWS	WOP	POWSWOP
POX	OP	POXOP
PRAHU	HARP	PRAHUHARP
PRATE	TARP	PRATETARP
PRAWN	WARP	PRAWNWARP
PREPS	PERP	PREPSPERP
PRODDED	DORP	PRODDEDDORP
PROGS	GORP	PROGSGORP
PUB	UP	PUBUP
PUCE	CUP	PUCECUP
PUCK	CUP	PUCKCUP
PUD	UP	PUDUP
PUDS	DUP	PUDSDUP
PUFF	UP	PUFFUP
PUG	UP	PUGUP
PUL	UP	PULUP
PULL	UP	PULLUP
PULLUPS	PULLUP	PULLUPSPULLUP
PUN	UP	PUNUP
PUP	UP	PUPUP
PUPA	PUP	PUPAPUP
PUPS	PUP	PUPSPUP
PUPU	PUP	PUPUPUP
PUR	UP	PURUP
PURER	UP	PURERUP
PURISM	SIRUP	PURISMSIRUP
PURIST	SIRUP	PURISTSIRUP
PURR	UP	PURRUP
PUS	UP	PUSUP
PUSES	UP	PUSESUP
PUSH	SUP	PUSHSUP
PUSS	UP	PUSSUP
PUSS	SUP	PUSSSUP
PUSSES	SUP	PUSSESSUP
PUT	UP	PUTUP
PUTS	TUP	PUTSTUP
PUTT	UP	PUTTUP
PUTT	TUP	PUTTTUP
PUTZ	TUP	PUTZTUP
RACE	CAR	RACECAR
RACEME	CAR	RACEMECAR
RACK	CAR	RACKCAR
RACY	CAR	RACYCAR
RAD	AR	RADAR
RADARS	RADAR	RADARSRADAR
RAFF	AR	RAFFAR
RAFT	FAR	RAFTFAR
RAG	AR	RAGAR
RAGA	GAR	RAGAGAR
RAGAS	AGAR	RAGASAGAR
RAGE	GAR	RAGEGAR
RAGEE	GAR	RAGEEGAR
RAGG	AR	RAGGAR
RAGG	GAR	RAGGGAR
RAGGEE	EGGAR	RAGGEEEGGAR
RAGI	GAR	RAGIGAR
RAGS	GAR	RAGSGAR
RAH	AR	RAHAR
RAI	AR	RAIAR
RAILS	LIAR	RAILSLIAR
RAJ	AR	RAJAR
RAJA	JAR	RAJAJAR
RAJAH	AJAR	RAJAHAJAR
RAJAS	AJAR	RAJASAJAR
RALE	LAR	RALELAR
RAM	AR	RAMAR
RAMADA	MAR	RAMADAMAR
RAMEE	MAR	RAMEEMAR
RAMI	MAR	RAMIMAR
RAMP	MAR	RAMPMAR
RAMS	MAR	RAMSMAR
RAN	AR	RANAR
RANGE	GNAR	RANGEGNAR
RANGY	GNAR	RANGYGNAR
RANIDS	DINAR	RANIDSDINAR
RANKS	KNAR	RANKSKNAR
RAP	AR	RAPAR
RAPE	PAR	RAPEPAR
RAPINI	PAR	RAPINIPAR
RAPS	PAR	RAPSPAR
RAPT	PAR	RAPTPAR
RARER	AR	RARERAR
RAS	AR	RASAR
RASES	AR	RASESAR
RASPS	AR	RASPSAR
RAT	AR	RATAR
RATATAT	AR	RATATATAR
RATE	TAR	RATETAR
RATH	TAR	RATHTAR
RATO	TAR	RATOTAR
RATS	TAR	RATSTAR
RATTON	OTTAR	RATTONOTTAR
RAVE	VAR	RAVEVAR
RAW	AR	RAWAR
RAWS	WAR	RAWSWAR
RAX	AR	RAXAR
RAY	AR	RAYAR
RAYA	YAR	RAYAYAR
RAYS	YAR	RAYSYAR
RAZZ	AR	RAZZAR
REATA	ER	REATAER
REB	ER	REBER
REBATO	TABER	REBATOTABER
REBUTS	TUBER	REBUTSTUBER
REC	ER	RECER
RECALL	LACER	RECALLLACER
RECAPS	PACER	RECAPSPACER
RECLUSES	ULCER	RECLUSESULCER
RED	ER	REDER
REDD	ER	REDDER
REDDERS	REDDER	REDDERSREDDER
REDED	ER	REDEDER
REDIAE	AIDER	REDIAEAIDER
REDIAL	AIDER	REDIALAIDER
REDIAS	AIDER	REDIASAIDER
REDID	ER	REDIDER
REDLEGS	GELDER	REDLEGSGELDER
REDNESS	ENDER	REDNESSENDER
REDRAWERS	REWARDER	REDRAWERSREWARDER
REDRAWN	WARDER	REDRAWNWARDER
REDRAWS	WARDER	REDRAWSWARDER
REE	ER	REEER
REEDS	DEER	REEDSDEER
REEDY	DEER	REEDYDEER
REELS	LEER	REELSLEER
REEST	SEER	REESTSEER
REEVE	ER	REEVEER
REF	ER	REFER
REFEREE	REFER	REFEREEREFER
REFERRER	REFER	REFERRERREFER
REFERS	REFER	REFERSREFER
REFILE	LIFER	REFILELIFER
REFILL	LIFER	REFILLLIFER
REFILM	LIFER	REFILMLIFER
REFLETS	TELFER	REFLETSTELFER
REFLOWN	WOLFER	REFLOWNWOLFER
REFLOWS	WOLFER	REFLOWSWOLFER
REFS	FER	REFSFER
REFT	FER	REFTFER
REG	ER	REGER
REGAL	AGER	REGALAGER
REGALE	LAGER	REGALELAGER
REGES	EGER	REGESEGER
REGILDED	LIGER	REGILDEDLIGER
REGILT	LIGER	REGILTLIGER
REGNAL	ANGER	REGNALANGER
REGRESSES	SERGER	REGRESSESSERGER
REGULI	LUGER	REGULILUGER
REI	ER	REIER
REIFIERS	REIFIER	REIFIERSREIFIER
REKNITS	TINKER	REKNITSTINKER
RELAPSES	PALER	RELAPSESPALER
RELATE	TALER	RELATETALER
RELIEVE	VEILER	RELIEVEVEILER
RELIEVO	VEILER	RELIEVOVEILER
RELIVE	VILER	RELIVEVILER
RELIVED	EVILER	RELIVEDEVILER
RELIVES	EVILER	RELIVESEVILER
REM	ER	REMER
REMAND	NAMER	REMANDNAMER
REMANDED	NAMER	REMANDEDNAMER
REMANS	NAMER	REMANSNAMER
REMATE	TAMER	REMATETAMER
REMEETS	TEEMER	REMEETSTEEMER
REMITS	TIMER	REMITSTIMER
REMODELED	OMER	REMODELEDOMER
REMODELLED	OMER	REMODELLEDOMER
REMOVE	VOMER	REMOVEVOMER
RENIN	ER	RENINER
RENNETS	TENNER	RENNETSTENNER
RENNIN	INNER	RENNININNER
REP	ER	REPER
REPACK	CAPER	REPACKCAPER
REPAPERS	REPAPER	REPAPERSREPAPER
REPARK	RAPER	REPARKRAPER
REPASS	APER	REPASSAPER
REPASTS	APER	REPASTSAPER
REPAY	APER	REPAYAPER
REPELS	LEPER	REPELSLEPER
REPO	PER	REPOPER
REPOLL	LOPER	REPOLLLOPER
REPORT	ROPER	REPORTROPER
REPOTS	TOPER	REPOTSTOPER
REPP	ER	REPPER
REPP	PER	REPPPER
REPRESSER	PER	REPRESSERPER
REPS	PER	REPSPER
RES	ER	RESER
RESEE	SER	RESEESER
RESEES	ER	RESEESER
RESH	SER	RESHSER
RESODDED	DOSER	RESODDEDDOSER
RESOLD	LOSER	RESOLDLOSER
RESOLDERED	LOSER	RESOLDEREDLOSER
RESOLE	LOSER	RESOLELOSER
REST	SER	RESTSER
RESTS	ER	RESTSER
RESUME	MUSER	RESUMEMUSER
RET	ER	RETER
RETAGS	GATER	RETAGSGATER
RETARDED	RATER	RETARDEDRATER
RETEMS	METER	RETEMSMETER
RETINE	NITER	RETINENITER
RETINENE	NITER	RETINENENITER
RETINT	NITER	RETINTNITER
RETINUE	UNITER	RETINUEUNITER
REUSE	SUER	REUSESUER
REV	ER	REVER
REVEL	EVER	REVELEVER
REVELS	LEVER	REVELSLEVER
REVERER	EVER	REVEREREVER
REVEST	SEVER	REVESTSEVER
REVESTS	EVER	REVESTSEVER
REVET	EVER	REVETEVER
REVISE	SIVER	REVISESIVER
REVIVERS	REVIVER	REVIVERSREVIVER
REWARDED	RAWER	REWARDEDRAWER
REWARDERS	REDRAWER	REWARDERSREDRAWER
REWASH	SAWER	REWASHSAWER
REWED	EWER	REWEDEWER
REWET	EWER	REWETEWER
REWORDED	ROWER	REWORDEDROWER
REWORE	ROWER	REWOREROWER
REWORK	ROWER	REWORKROWER
REWORN	ROWER	REWORNROWER
REWOVE	VOWER	REWOVEVOWER
REX	ER	REXER
RIAL	AIR	RIALAIR
RIALS	LAIR	RIALSLAIR
RIAS	AIR	RIASAIR
RIFE	FIR	RIFEFIR
RIFF	FIR	RIFFFIR
RIFS	FIR	RIFSFIR
RIFT	FIR	RIFTFIR
RIME	MIR	RIMEMIR
RIMED	EMIR	RIMEDEMIR
RIMER	EMIR	RIMEREMIR
RIMES	EMIR	RIMESEMIR
RIMS	MIR	RIMSMIR
RIMY	MIR	RIMYMIR
RISK	SIR	RISKSIR
RISOTTO	SIR	RISOTTOSIR
ROB	OR	ROBOR
ROBALO	LABOR	ROBALOLABOR
ROC	OR	ROCOR
ROCK	COR	ROCKCOR
ROCOCO	COR	ROCOCOCOR
ROCS	COR	ROCSCOR
ROD	OR	RODOR
RODDED	DOR	RODDEDDOR
RODE	DOR	RODEDOR
RODEOED	OR	RODEOEDOR
RODS	DOR	RODSDOR
ROE	OR	ROEOR
ROLL	OR	ROLLOR
ROM	OR	ROMOR
ROMP	MOR	ROMPMOR
ROMS	MOR	ROMSMOR
ROODS	DOOR	ROODSDOOR
ROOMETTE	MOOR	ROOMETTEMOOR
ROOMS	MOOR	ROOMSMOOR
ROSELLES	OR	ROSELLESOR
ROSES	OR	ROSESOR
ROSETTES	OR	ROSETTESOR
ROSIEST	SEISOR	ROSIESTSEISOR
ROT	OR	ROTOR
ROTA	TOR	ROTATOR
ROTATIVELY	LEVITATOR	ROTATIVELYLEVITATOR
ROTATORS	ROTATOR	ROTATORSROTATOR
ROTATORY	ROTATOR	ROTATORYROTATOR
ROTE	TOR	ROTETOR
ROTENONE	TOR	ROTENONETOR
ROTI	TOR	ROTITOR
ROTL	TOR	ROTLTOR
ROTO	TOR	ROTOTOR
ROTORS	ROTOR	ROTORSROTOR
ROTS	TOR	ROTSTOR
ROW	OR	ROWOR
RUBE	BUR	RUBEBUR
RUCK	CUR	RUCKCUR
RUFF	FUR	RUFFFUR
SABAL	ABAS	SABALABAS
SABBAT	ABBAS	SABBATABBAS
SABE	BAS	SABEBAS
SABS	BAS	SABSBAS
SAC	AS	SACAS
SAD	AS	SADAS
SAE	AS	SAEAS
SAFE	FAS	SAFEFAS
SAG	AS	SAGAS
SAGA	GAS	SAGAGAS
SAGAS	AGAS	SAGASAGAS
SAGE	GAS	SAGEGAS
SAGO	GAS	SAGOGAS
SAGS	GAS	SAGSGAS
SAGY	GAS	SAGYGAS
SAKI	KAS	SAKIKAS
SAL	AS	SALAS
SALAD	ALAS	SALADALAS
SALAL	AS	SALALAS
SALAL	ALAS	SALALALAS
SALE	LAS	SALELAS
SALL	AS	SALLAS
SALL	LAS	SALLLAS
SALOL	AS	SALOLAS
SALP	LAS	SALPLAS
SALS	LAS	SALSLAS
SALSAS	LAS	SALSASLAS
SALT	LAS	SALTLAS
SAMARA	MAS	SAMARAMAS
SAME	MAS	SAMEMAS
SAMP	MAS	SAMPMAS
SAMSARAS	MAS	SAMSARASMAS
SAP	AS	SAPAS
SAPS	PAS	SAPSPAS
SARAPE	PARAS	SARAPEPARAS
SARD	RAS	SARDRAS
SAREE	RAS	SAREERAS
SARI	RAS	SARIRAS
SARK	RAS	SARKRAS
SASS	AS	SASSAS
SAT	AS	SATAS
SATARA	TAS	SATARATAS
SATE	TAS	SATETAS
SATED	ETAS	SATEDETAS
SATEM	ETAS	SATEMETAS
SATES	ETAS	SATESETAS
SATI	TAS	SATITAS
SAU	AS	SAUAS
SAVANNA	VAS	SAVANNAVAS
SAVE	VAS	SAVEVAS
SAW	AS	SAWAS
SAX	AS	SAXAS
SAY	AS	SAYAS
SAYER	EYAS	SAYEREYAS
SCALD	LACS	SCALDLACS
SCALDED	LACS	SCALDEDLACS
SCALE	LACS	SCALELACS
SCALENE	LACS	SCALENELACS
SCALL	LACS	SCALLLACS
SCAMP	MACS	SCAMPMACS
SCAMS	MACS	SCAMSMACS
SCAPE	PACS	SCAPEPACS
SCORCH	CROCS	SCORCHCROCS
SCORE	ROCS	SCOREROCS
SCORN	ROCS	SCORNROCS
SCRAG	ARCS	SCRAGARCS
SCRAM	ARCS	SCRAMARCS
SCRAP	ARCS	SCRAPARCS
SCROD	ORCS	SCRODORCS
SCROLL	ORCS	SCROLLORCS
SCROTA	TORCS	SCROTATORCS
SEAMS	MAES	SEAMSMAES
SEAMY	MAES	SEAMYMAES
SEC	ES	SECES
SECRETE	TERCES	SECRETETERCES
SECRETS	TERCES	SECRETSTERCES
SEDERS	REDES	SEDERSREDES
SEE	ES	SEEES
SEEDS	DEES	SEEDSDEES
SEELS	LEES	SEELSLEES
SEELY	LEES	SEELYLEES
SEEPS	PEES	SEEPSPEES
SEEPY	PEES	SEEPYPEES
SEERS	REES	SEERSREES
SEG	ES	SEGES
SEI	ES	SEIES
SEL	ES	SELES
SELAH	ALES	SELAHALES
SELAHS	HALES	SELAHSHALES
SELF	LES	SELFLES
SELL	ES	SELLES
SELL	LES	SELLLES
SELS	LES	SELSLES
SEMEME	MEMES	SEMEMEMEMES
SEMEN	EMES	SEMENEMES
SEMES	EMES	SEMESEMES
SEMINAL	ANIMES	SEMINALANIMES
SEN	ES	SENES
SENEGAS	AGENES	SENEGASAGENES
SENOR	ONES	SENORONES
SENSED	ESNES	SENSEDESNES
SENSEI	ESNES	SENSEIESNES
SENSES	ESNES	SENSESESNES
SEPSES	PES	SEPSESPES
SEPSIS	PES	SEPSISPES
SEPT	PES	SEPTPES
SEPTET	PES	SEPTETPES
SER	ES	SERES
SERA	RES	SERARES
SERAC	ARES	SERACARES
SERACS	CARES	SERACSCARES
SERAI	ARES	SERAIARES
SERAL	ARES	SERALARES
SERAPH	PARES	SERAPHPARES
SERE	RES	SERERES
SERENE	RES	SERENERES
SERENER	ES	SERENERES
SERER	ES	SERERES
SEREST	SERES	SERESTSERES
SERF	RES	SERFRES
SERIF	IRES	SERIFIRES
SERIFS	FIRES	SERIFSFIRES
SERIN	IRES	SERINIRES
SEROSAS	ORES	SEROSASORES
SEROW	ORES	SEROWORES
SERRATE	TARRES	SERRATETARRES
SERS	RES	SERSRES
SERUMS	MURES	SERUMSMURES
SERVILE	LIVRES	SERVILELIVRES
SESTETS	ES	SESTETSES
SET	ES	SETES
SETAE	ATES	SETAEATES
SETAL	ATES	SETALATES
SETONS	NOTES	SETONSNOTES
SETT	ES	SETTES
SETUP	UTES	SETUPUTES
SEVENS	NEVES	SEVENSNEVES
SEVER	EVES	SEVEREVES
SEVERER	EVES	SEVEREREVES
SEW	ES	SEWES
SEWAN	AWES	SEWANAWES
SEWAR	AWES	SEWARAWES
SEWED	EWES	SEWEDEWES
SEWER	EWES	SEWEREWES
SEX	ES	SEXES
SEXED	EXES	SEXEDEXES
SEXES	EXES	SEXESEXES
SEXING	NIXES	SEXINGNIXES
SEXIST	SIXES	SEXISTSIXES
SHAD	AHS	SHADAHS
SHADE	DAHS	SHADEDAHS
SHADED	AHS	SHADEDAHS
SHADOW	ODAHS	SHADOWODAHS
SHADS	DAHS	SHADSDAHS
SHADY	DAHS	SHADYDAHS
SHAG	AHS	SHAGAHS
SHAH	AHS	SHAHAHS
SHAHS	HAHS	SHAHSHAHS
SHALL	AHS	SHALLAHS
SHAM	AHS	SHAMAHS
SHAMAN	AMAHS	SHAMANAMAHS
SHAMAS	AMAHS	SHAMASAMAHS
SHARER	AHS	SHARERAHS
SHAT	AHS	SHATAHS
SHAW	AHS	SHAWAHS
SHAY	AHS	SHAYAHS
SHOD	OHS	SHODOHS
SHOE	OHS	SHOEOHS
SHOG	OHS	SHOGOHS
SHOO	OHS	SHOOOHS
SHOOK	OOHS	SHOOKOOHS
SHOOL	OOHS	SHOOLOOHS
SHOON	OOHS	SHOONOOHS
SHOOS	OOHS	SHOOSOOHS
SHOOT	OOHS	SHOOTOOHS
SHOP	OHS	SHOPOHS
SHOT	OHS	SHOTOHS
SHOTT	OHS	SHOTTOHS
SHOW	OHS	SHOWOHS
SHTETL	TETHS	SHTETLTETHS
SHTIKS	KITHS	SHTIKSKITHS
SIAL	AIS	SIALAIS
SIB	IS	SIBIS
SIBB	IS	SIBBIS
SIBB	BIS	SIBBBIS
SIBS	BIS	SIBSBIS
SIC	IS	SICIS
SICE	CIS	SICECIS
SICK	CIS	SICKCIS
SICS	CIS	SICSCIS
SIDE	DIS	SIDEDIS
SIDED	IS	SIDEDIS
SIDH	DIS	SIDHDIS
SIEGE	IS	SIEGEIS
SIEVE	IS	SIEVEIS
SIGNING	IS	SIGNINGIS
SIKE	KIS	SIKEKIS
SILD	LIS	SILDLIS
SILK	LIS	SILKLIS
SILL	IS	SILLIS
SILL	LIS	SILLLIS
SILO	LIS	SILOLIS
SILT	LIS	SILTLIS
SIM	IS	SIMIS
SIMA	MIS	SIMAMIS
SIMAR	AMIS	SIMARAMIS
SIMAS	AMIS	SIMASAMIS
SIMOOM	IS	SIMOOMIS
SIMP	MIS	SIMPMIS
SIMS	MIS	SIMSMIS
SIN	IS	SINIS
SIP	IS	SIPIS
SIPE	PIS	SIPEPIS
SIPS	PIS	SIPSPIS
SIR	IS	SIRIS
SIRRAH	ARRIS	SIRRAHARRIS
SIRRAS	ARRIS	SIRRASARRIS
SIRUPS	PURIS	SIRUPSPURIS
SIRUPY	PURIS	SIRUPYPURIS
SIS	IS	SISIS
SISES	IS	SISESIS
SISSES	SIS	SISSESSIS
SIT	IS	SITIS
SITE	TIS	SITETIS
SITH	TIS	SITHTIS
SITS	TIS	SITSTIS
SIX	IS	SIXIS
SKELL	LEKS	SKELLLEKS
SKELM	LEKS	SKELMLEKS
SKELP	LEKS	SKELPLEKS
SKUAS	AUKS	SKUASAUKS
SLAB	ALS	SLABALS
SLABS	BALS	SLABSBALS
SLAG	ALS	SLAGALS
SLAGS	GALS	SLAGSGALS
SLAM	ALS	SLAMALS
SLAP	ALS	SLAPALS
SLAPS	PALS	SLAPSPALS
SLAT	ALS	SLATALS
SLAW	ALS	SLAWALS
SLAY	ALS	SLAYALS
SLED	ELS	SLEDELS
SLEDDED	DELS	SLEDDEDDELS
SLEDS	DELS	SLEDSDELS
SLEEKS	KEELS	SLEEKSKEELS
SLEEKY	KEELS	SLEEKYKEELS
SLEEP	EELS	SLEEPEELS
SLEEPS	PEELS	SLEEPSPEELS
SLEET	EELS	SLEETEELS
SLEETS	TEELS	SLEETSTEELS
SLEETY	TEELS	SLEETYTEELS
SLEEVE	ELS	SLEEVEELS
SLEW	ELS	SLEWELS
SLIEVE	VEILS	SLIEVEVEILS
SLIME	MILS	SLIMEMILS
SLIMS	MILS	SLIMSMILS
SLING	NILS	SLINGNILS
SLIPUPS	PUPILS	SLIPUPSPUPILS
SLITS	TILS	SLITSTILS
SLIVERER	EVILS	SLIVEREREVILS
SLOIDS	DIOLS	SLOIDSDIOLS
SLOOPS	POOLS	SLOOPSPOOLS
SLOPE	POLS	SLOPEPOLS
SLOPS	POLS	SLOPSPOLS
SLUGS	GULS	SLUGSGULS
SMALT	LAMS	SMALTLAMS
SMARM	RAMS	SMARMRAMS
SMART	RAMS	SMARTRAMS
SMARTS	TRAMS	SMARTSTRAMS
SMARTY	TRAMS	SMARTYTRAMS
SMELL	EMS	SMELLEMS
SMEW	EMS	SMEWEMS
SMIRK	RIMS	SMIRKRIMS
SMOG	OMS	SMOGOMS
SNAFU	FANS	SNAFUFANS
SNAPS	PANS	SNAPSPANS
SNATH	TANS	SNATHTANS
SNAWS	WANS	SNAWSWANS
SNED	ENS	SNEDENS
SNEDDED	DENS	SNEDDEDDENS
SNEDS	DENS	SNEDSDENS
SNEEZE	ENS	SNEEZEENS
SNELL	ENS	SNELLENS
SNIBS	BINS	SNIBSBINS
SNIFF	INS	SNIFFINS
SNIP	INS	SNIPINS
SNIPE	PINS	SNIPEPINS
SNIPERS	REPINS	SNIPERSREPINS
SNIPS	PINS	SNIPSPINS
SNIT	INS	SNITINS
SNITS	TINS	SNITSTINS
SNIVELS	LEVINS	SNIVELSLEVINS
SNOG	ONS	SNOGONS
SNOOLS	LOONS	SNOOLSLOONS
SNOOPS	POONS	SNOOPSPOONS
SNOOPY	POONS	SNOOPYPOONS
SNOOTS	TOONS	SNOOTSTOONS
SNOOTY	TOONS	SNOOTYTOONS
SNOOZY	ZOONS	SNOOZYZOONS
SNORER	ONS	SNORERONS
SNOT	ONS	SNOTONS
SNOTS	TONS	SNOTSTONS
SNOW	ONS	SNOWONS
SNOWS	WONS	SNOWSWONS
SNOWY	WONS	SNOWYWONS
SNUBS	BUNS	SNUBSBUNS
SNUFF	UNS	SNUFFUNS
SNUG	UNS	SNUGUNS
SNUGS	GUNS	SNUGSGUNS
SOB	OS	SOBOS
SOBA	BOS	SOBABOS
SOBAS	ABOS	SOBASABOS
SOBS	BOS	SOBSBOS
SOCK	COS	SOCKCOS
SOD	OS	SODOS
SODA	DOS	SODADOS
SODAS	ADOS	SODASADOS
SODDED	DOS	SODDEDDOS
SODDENED	DOS	SODDENEDDOS
SODS	DOS	SODSDOS
SOKE	KOS	SOKEKOS
SOL	OS	SOLOS
SOM	OS	SOMOS
SOMA	MOS	SOMAMOS
SOMATA	MOS	SOMATAMOS
SOME	MOS	SOMEMOS
SOMS	MOS	SOMSMOS
SON	OS	SONOS
SONATA	NOS	SONATANOS
SONE	NOS	SONENOS
SONG	NOS	SONGNOS
SONS	NOS	SONSNOS
SOP	OS	SOPOS
SORBS	BROS	SORBSBROS
SORED	EROS	SOREDEROS
SOREL	EROS	SORELEROS
SORER	OS	SOREROS
SORER	EROS	SOREREROS
SORES	EROS	SORESEROS
SORTERS	RETROS	SORTERSRETROS
SORTING	NITROS	SORTINGNITROS
SOS	OS	SOSOS
SOT	OS	SOTOS
SOTOLS	LOTOS	SOTOLSLOTOS
SOU	OS	SOUOS
SOW	OS	SOWOS
SOWN	WOS	SOWNWOS
SOWS	WOS	SOWSWOS
SOX	OS	SOXOS
SOY	OS	SOYOS
SPACERS	RECAPS	SPACERSRECAPS
SPACY	CAPS	SPACYCAPS
SPADO	DAPS	SPADODAPS
SPAHEE	HAPS	SPAHEEHAPS
SPAHI	HAPS	SPAHIHAPS
SPALE	LAPS	SPALELAPS
SPALL	LAPS	SPALLLAPS
SPAMS	MAPS	SPAMSMAPS
SPANG	NAPS	SPANGNAPS
SPANK	NAPS	SPANKNAPS
SPANS	NAPS	SPANSNAPS
SPARE	RAPS	SPARERAPS
SPARK	RAPS	SPARKRAPS
SPARS	RAPS	SPARSRAPS
SPASM	SAPS	SPASMSAPS
SPATE	TAPS	SPATETAPS
SPATS	TAPS	SPATSTAPS
SPAWN	WAPS	SPAWNWAPS
SPAZZ	ZAPS	SPAZZZAPS
SPECK	CEPS	SPECKCEPS
SPECS	CEPS	SPECSCEPS
SPEEDO	DEEPS	SPEEDODEEPS
SPEEDS	DEEPS	SPEEDSDEEPS
SPEEDY	DEEPS	SPEEDYDEEPS
SPIKE	KIPS	SPIKEKIPS
SPIKS	KIPS	SPIKSKIPS
SPIKY	KIPS	SPIKYKIPS
SPILE	LIPS	SPILELIPS
SPILL	LIPS	SPILLLIPS
SPILT	LIPS	SPILTLIPS
SPINE	NIPS	SPINENIPS
SPINELLE	NIPS	SPINELLENIPS
SPINS	NIPS	SPINSNIPS
SPIRAEA	RIPS	SPIRAEARIPS
SPIRE	RIPS	SPIRERIPS
SPIREME	RIPS	SPIREMERIPS
SPIRT	RIPS	SPIRTRIPS
SPIRTS	TRIPS	SPIRTSTRIPS
SPITE	TIPS	SPITETIPS
SPITS	TIPS	SPITSTIPS
SPITZ	TIPS	SPITZTIPS
SPLAT	ALPS	SPLATALPS
SPLAY	ALPS	SPLAYALPS
SPOKE	KOPS	SPOKEKOPS
SPOOF	OOPS	SPOOFOOPS
SPOOK	OOPS	SPOOKOOPS
SPOOL	OOPS	SPOOLOOPS
SPOOLS	LOOPS	SPOOLSLOOPS
SPOON	OOPS	SPOONOOPS
SPOOR	OOPS	SPOOROOPS
SPOT	OPS	SPOTOPS
SPOTS	TOPS	SPOTSTOPS
SPRATS	TARPS	SPRATSTARPS
SPRAWL	WARPS	SPRAWLWARPS
SPRUE	URPS	SPRUEURPS
SPRUG	URPS	SPRUGURPS
SPUDDED	DUPS	SPUDDEDDUPS
SPUDS	DUPS	SPUDSDUPS
SPUE	UPS	SPUEUPS
SPUN	UPS	SPUNUPS
SPUR	UPS	SPURUPS
STABS	BATS	STABSBATS
STACK	CATS	STACKCATS
STAGE	GATS	STAGEGATS
STAGS	GATS	STAGSGATS
STAGY	GATS	STAGYGATS
STAKE	KATS	STAKEKATS
STALE	LATS	STALELATS
STALK	LATS	STALKLATS
STALL	LATS	STALLLATS
STAMP	MATS	STAMPMATS
STANGS	GNATS	STANGSGNATS
STAPH	PATS	STAPHPATS
STARE	RATS	STARERATS
STARK	RATS	STARKRATS
STARS	RATS	STARSRATS
START	RATS	STARTRATS
STATE	TATS	STATETATS
STATS	TATS	STATSTATS
STAVE	VATS	STAVEVATS
STEEDS	DEETS	STEEDSDEETS
STEEKS	KEETS	STEEKSKEETS
STEELS	LEETS	STEELSLEETS
STELE	LETS	STELELETS
STELENE	LETS	STELENELETS
STELLIFY	FILLETS	STELLIFYFILLETS
STEMMED	EMMETS	STEMMEDEMMETS
STEMMER	EMMETS	STEMMEREMMETS
STENO	NETS	STENONETS
STENT	NETS	STENTNETS
STEPS	PETS	STEPSPETS
STERE	RETS	STERERETS
STERN	RETS	STERNRETS
STETS	TETS	STETSTETS
STEWS	WETS	STEWSWETS
STEWY	WETS	STEWYWETS
STIFF	ITS	STIFFITS
STILE	LITS	STILELITS
STILL	ITS	STILLITS
STILL	LITS	STILLLITS
STILT	LITS	STILTLITS
STIMES	EMITS	STIMESEMITS
STING	NITS	STINGNITS
STINK	NITS	STINKNITS
STINKEROO	REKNITS	STINKEROOREKNITS
STINKO	KNITS	STINKOKNITS
STINKS	KNITS	STINKSKNITS
STINKY	KNITS	STINKYKNITS
STINT	NITS	STINTNITS
STIR	ITS	STIRITS
STOBS	BOTS	STOBSBOTS
STOCK	COTS	STOCKCOTS
STOLE	LOTS	STOLELOTS
STOMATA	MOTS	STOMATAMOTS
STOMP	MOTS	STOMPMOTS
STOOD	OOTS	STOODOOTS
STOOK	OOTS	STOOKOOTS
STOOL	OOTS	STOOLOOTS
STOOLS	LOOTS	STOOLSLOOTS
STOOP	OOTS	STOOPOOTS
STOPE	POTS	STOPEPOTS
STOPERS	REPOTS	STOPERSREPOTS
STOPS	POTS	STOPSPOTS
STOPT	POTS	STOPTPOTS
STORE	ROTS	STOREROTS
STORK	ROTS	STORKROTS
STORM	ROTS	STORMROTS
STORY	ROTS	STORYROTS
STOSS	SOTS	STOSSSOTS
STOTS	TOTS	STOTSTOTS
STOTT	TOTS	STOTTTOTS
STOWP	WOTS	STOWPWOTS
STOWS	WOTS	STOWSWOTS
STRAKE	KARTS	STRAKEKARTS
STRAP	ARTS	STRAPARTS
STRAPS	PARTS	STRAPSPARTS
STRASS	ARTS	STRASSARTS
STRATA	TARTS	STRATATARTS
STRATH	TARTS	STRATHTARTS
STRATI	TARTS	STRATITARTS
STRAW	ARTS	STRAWARTS
STRAWS	WARTS	STRAWSWARTS
STRAWY	WARTS	STRAWYWARTS
STRAY	ARTS	STRAYARTS
STRIAE	AIRTS	STRIAEAIRTS
STROBILI	BORTS	STROBILIBORTS
STROLL	ORTS	STROLLORTS
STROMA	MORTS	STROMAMORTS
STROMATA	MORTS	STROMATAMORTS
STROP	ORTS	STROPORTS
STROPS	PORTS	STROPSPORTS
STROW	ORTS	STROWORTS
STROWN	WORTS	STROWNWORTS
STROWS	WORTS	STROWSWORTS
STROY	ORTS	STROYORTS
STUBS	BUTS	STUBSBUTS
STUCK	CUTS	STUCKCUTS
STUD	UTS	STUDUTS
STUFF	UTS	STUFFUTS
STULL	UTS	STULLUTS
STUM	UTS	STUMUTS
STUMP	MUTS	STUMPMUTS
STUMS	MUTS	STUMSMUTS
STUN	UTS	STUNUTS
STUNG	NUTS	STUNGNUTS
STUNK	NUTS	STUNKNUTS
STUNS	NUTS	STUNSNUTS
STUNT	NUTS	STUNTNUTS
STUPE	PUTS	STUPEPUTS
STURT	RUTS	STURTRUTS
SUB	US	SUBUS
SUBA	BUS	SUBABUS
SUBAHS	HABUS	SUBAHSHABUS
SUBERS	REBUS	SUBERSREBUS
SUBLEVEL	BUS	SUBLEVELBUS
SUBS	BUS	SUBSBUS
SUBSERES	BUS	SUBSERESBUS
SUBURB	RUBUS	SUBURBRUBUS
SUCRASES	ARCUS	SUCRASESARCUS
SUDD	US	SUDDUS
SUE	US	SUEUS
SUEDE	US	SUEDEUS
SUK	US	SUKUS
SULFO	FLUS	SULFOFLUS
SULUS	ULUS	SULUSULUS
SUM	US	SUMUS
SUMAC	AMUS	SUMACAMUS
SUMO	MUS	SUMOMUS
SUMP	MUS	SUMPMUS
SUMS	MUS	SUMSMUS
SUN	US	SUNUS
SUNDERED	NUS	SUNDEREDNUS
SUNG	NUS	SUNGNUS
SUNK	NUS	SUNKNUS
SUNN	US	SUNNUS
SUNN	NUS	SUNNNUS
SUNS	NUS	SUNSNUS
SUP	US	SUPUS
SUPE	PUS	SUPEPUS
SUPREMER	PUS	SUPREMERPUS
SUPS	PUS	SUPSPUS
SUQ	US	SUQUS
SURER	US	SURERUS
SUSS	US	SUSSUS
SUSURRUS	US	SUSURRUSUS
SWAMI	MAWS	SWAMIMAWS
SWAMP	MAWS	SWAMPMAWS
SWAMY	MAWS	SWAMYMAWS
SWAPS	PAWS	SWAPSPAWS
SWARD	RAWS	SWARDRAWS
SWARDED	RAWS	SWARDEDRAWS
SWARDS	DRAWS	SWARDSDRAWS
SWARE	RAWS	SWARERAWS
SWARF	RAWS	SWARFRAWS
SWARM	RAWS	SWARMRAWS
SWART	RAWS	SWARTRAWS
SWASH	SAWS	SWASHSAWS
SWATH	TAWS	SWATHTAWS
SWATS	TAWS	SWATSTAWS
SWEDE	DEWS	SWEDEDEWS
SWOBS	BOWS	SWOBSBOWS
SWORD	ROWS	SWORDROWS
SWORE	ROWS	SWOREROWS
SWORN	ROWS	SWORNROWS
SWOTS	TOWS	SWOTSTOWS
SYBO	BYS	SYBOBYS
TAB	AT	TABAT
TABARD	RABAT	TABARDRABAT
TABARDED	RABAT	TABARDEDRABAT
TABOO	BAT	TABOOBAT
TAC	AT	TACAT
TACE	CAT	TACECAT
TACH	CAT	TACHCAT
TACK	CAT	TACKCAT
TACO	CAT	TACOCAT
TACT	CAT	TACTCAT
TAD	AT	TADAT
TAE	AT	TAEAT
TAEL	EAT	TAELEAT
TAG	AT	TAGAT
TAGS	GAT	TAGSGAT
TAHR	HAT	TAHRHAT
TAJ	AT	TAJAT
TAKA	KAT	TAKAKAT
TAKE	KAT	TAKEKAT
TAKIN	IKAT	TAKINIKAT
TALC	LAT	TALCLAT
TALCED	ECLAT	TALCEDECLAT
TALE	LAT	TALELAT
TALI	LAT	TALILAT
TALK	LAT	TALKLAT
TALL	AT	TALLAT
TALL	LAT	TALLLAT
TALLOL	LAT	TALLOLLAT
TAM	AT	TAMAT
TAME	MAT	TAMEMAT
TAMP	MAT	TAMPMAT
TAMS	MAT	TAMSMAT
TAN	AT	TANAT
TANGA	GNAT	TANGAGNAT
TANGO	GNAT	TANGOGNAT
TANGS	GNAT	TANGSGNAT
TANGY	GNAT	TANGYGNAT
TAO	AT	TAOAT
TAOS	OAT	TAOSOAT
TAP	AT	TAPAT
TAPA	PAT	TAPAPAT
TAPE	PAT	TAPEPAT
TAPS	PAT	TAPSPAT
TAR	AT	TARAT
TARAMA	RAT	TARAMARAT
TARDO	DRAT	TARDODRAT
TARDY	DRAT	TARDYDRAT
TARE	RAT	TARERAT
TARN	RAT	TARNRAT
TARO	RAT	TARORAT
TAROKS	KORAT	TAROKSKORAT
TARP	RAT	TARPRAT
TARPS	PRAT	TARPSPRAT
TARS	RAT	TARSRAT
TARSUS	RAT	TARSUSRAT
TART	RAT	TARTRAT
TAS	AT	TASAT
TASK	SAT	TASKSAT
TASKS	AT	TASKSAT
TASS	AT	TASSAT
TASS	SAT	TASSSAT
TASSES	SAT	TASSESSAT
TAT	AT	TATAT
TATE	TAT	TATETAT
TATS	TAT	TATSTAT
TAU	AT	TAUAT
TAV	AT	TAVAT
TAVS	VAT	TAVSVAT
TAW	AT	TAWAT
TAWS	WAT	TAWSWAT
TAWSE	SWAT	TAWSESWAT
TAWSES	WAT	TAWSESWAT
TAX	AT	TAXAT
TED	ET	TEDET
TEE	ET	TEEET
TEELS	LEET	TEELSLEET
TEEMERS	REMEET	TEEMERSREMEET
TEEMS	MEET	TEEMSMEET
TEFF	ET	TEFFET
TEG	ET	TEGET
TEGG	ET	TEGGET
TEGG	GET	TEGGGET
TEGS	GET	TEGSGET
TEL	ET	TELET
TELA	LET	TELALET
TELE	LET	TELELET
TELL	ET	TELLET
TELL	LET	TELLLET
TELS	LET	TELSLET
TEMP	MET	TEMPMET
TEN	ET	TENET
TEND	NET	TENDNET
TENDED	NET	TENDEDNET
TENDERED	NET	TENDEREDNET
TENETS	TENET	TENETSTENET
TENNERS	RENNET	TENNERSRENNET
TENON	ET	TENONET
TENONS	NONET	TENONSNONET
TENS	NET	TENSNET
TENSES	NET	TENSESNET
TENT	NET	TENTNET
TEPA	PET	TEPAPET
TEPEE	PET	TEPEEPET
TEREBENE	BERET	TEREBENEBERET
TERETE	RET	TERETERET
TERM	RET	TERMRET
TERN	RET	TERNRET
TERRETS	TERRET	TERRETSTERRET
TERROR	RET	TERRORRET
TEST	SET	TESTSET
TESTS	ET	TESTSET
TET	ET	TETET
TETH	TET	TETHTET
TETS	TET	TETSTET
TEW	ET	TEWET
TEWS	WET	TEWSWET
TIARA	IT	TIARAIT
TIC	IT	TICIT
TIDE	DIT	TIDEDIT
TIDED	IT	TIDEDIT
TIDED	EDIT	TIDEDEDIT
TIDES	EDIT	TIDESEDIT
TIDY	DIT	TIDYDIT
TIE	IT	TIEIT
TIFF	IT	TIFFIT
TIKI	KIT	TIKIKIT
TIL	IT	TILIT
TILAK	ALIT	TILAKALIT
TILE	LIT	TILELIT
TILERS	RELIT	TILERSRELIT
TILL	IT	TILLIT
TILL	LIT	TILLLIT
TILS	LIT	TILSLIT
TILT	LIT	TILTLIT
TIMED	EMIT	TIMEDEMIT
TIMER	EMIT	TIMEREMIT
TIMERS	REMIT	TIMERSREMIT
TIMES	EMIT	TIMESEMIT
TIMOLOL	OMIT	TIMOLOLOMIT
TIN	IT	TINIT
TINE	NIT	TINENIT
TING	NIT	TINGNIT
TINS	NIT	TINSNIT
TINT	NIT	TINTNIT
TINY	NIT	TINYNIT
TIP	IT	TIPIT
TIPI	PIT	TIPIPIT
TIPS	PIT	TIPSPIT
TIREDER	IT	TIREDERIT
TIS	IT	TISIT
TIT	IT	TITIT
TITI	TIT	TITITIT
TITS	TIT	TITSTIT
TOBY	BOT	TOBYBOT
TODS	DOT	TODSDOT
TODY	DOT	TODYDOT
TOGA	GOT	TOGAGOT
TOGS	GOT	TOGSGOT
TOLA	LOT	TOLALOT
TOLD	LOT	TOLDLOT
TOLE	LOT	TOLELOT
TOLL	LOT	TOLLLOT
TOLU	LOT	TOLULOT
TOMB	MOT	TOMBMOT
TOME	MOT	TOMEMOT
TOMS	MOT	TOMSMOT
TOMTIT	MOT	TOMTITMOT
TONE	NOT	TONENOT
TONEME	NOT	TONEMENOT
TONETTE	NOT	TONETTENOT
TONG	NOT	TONGNOT
TONS	NOT	TONSNOT
TOOK	OOT	TOOKOOT
TOOL	OOT	TOOLOOT
TOOM	OOT	TOOMOOT
TOON	OOT	TOONOOT
TOOT	OOT	TOOTOOT
TOPE	POT	TOPEPOT
TOPEE	POT	TOPEEPOT
TOPERS	REPOT	TOPERSREPOT
TOPH	POT	TOPHPOT
TOPI	POT	TOPIPOT
TOPO	POT	TOPOPOT
TOPS	POT	TOPSPOT
TORA	ROT	TORAROT
TORC	ROT	TORCROT
TORE	ROT	TOREROT
TORI	ROT	TORIROT
TORII	ROT	TORIIROT
TORN	ROT	TORNROT
TORO	ROT	TOROROT
TOROTH	TOROT	TOROTHTOROT
TORR	ROT	TORRROT
TORS	ROT	TORSROT
TORSES	ROT	TORSESROT
TORSKS	ROT	TORSKSROT
TORSOS	ROT	TORSOSROT
TORT	ROT	TORTROT
TORTA	TROT	TORTATROT
TORTE	TROT	TORTETROT
TORTS	TROT	TORTSTROT
TORY	ROT	TORYROT
TOTE	TOT	TOTETOT
TOTS	TOT	TOTSTOT
TOWN	WOT	TOWNWOT
TOWS	WOT	TOWSWOT
TOWY	WOT	TOWYWOT
TRACE	CART	TRACECART
TRACK	CART	TRACKCART
TRACT	CART	TRACTCART
TRAD	ART	TRADART
TRADE	DART	TRADEDART
TRADED	ART	TRADEDART
TRAM	ART	TRAMART
TRAMP	MART	TRAMPMART
TRAMS	MART	TRAMSMART
TRAP	ART	TRAPART
TRAPAN	APART	TRAPANAPART
TRAPEZE	PART	TRAPEZEPART
TRAPS	PART	TRAPSPART
TRAPT	PART	TRAPTPART
TRASS	ART	TRASSART
TRAWL	WART	TRAWLWART
TRAY	ART	TRAYART
TRIGNESS	ENGIRT	TRIGNESSENGIRT
TRIGO	GIRT	TRIGOGIRT
TRIGS	GIRT	TRIGSGIRT
TROD	ORT	TRODORT
TROG	ORT	TROGORT
TROLL	ORT	TROLLORT
TROMP	MORT	TROMPMORT
TROP	ORT	TROPORT
TROPE	PORT	TROPEPORT
TROT	ORT	TROTORT
TROTH	TORT	TROTHTORT
TROTS	TORT	TROTSTORT
TROW	ORT	TROWORT
TROWS	WORT	TROWSWORT
TROY	ORT	TROYORT
TRUCE	CURT	TRUCECURT
TRUCK	CURT	TRUCKCURT
TSETSES	TEST	TSETSESTEST
TUB	UT	TUBUT
TUBA	BUT	TUBABUT
TUBAE	ABUT	TUBAEABUT
TUBAL	ABUT	TUBALABUT
TUBAS	ABUT	TUBASABUT
TUBE	BUT	TUBEBUT
TUBERS	REBUT	TUBERSREBUT
TUBS	BUT	TUBSBUT
TUCK	CUT	TUCKCUT
TUFF	UT	TUFFUT
TUG	UT	TUGUT
TUGS	GUT	TUGSGUT
TUI	UT	TUIUT
TUMP	MUT	TUMPMUT
TUN	UT	TUNUT
TUNA	NUT	TUNANUT
TUNE	NUT	TUNENUT
TUNG	NUT	TUNGNUT
TUNS	NUT	TUNSNUT
TUP	UT	TUPUT
TUPS	PUT	TUPSPUT
TURBO	BRUT	TURBOBRUT
TURD	RUT	TURDRUT
TURF	RUT	TURFRUT
TURK	RUT	TURKRUT
TURN	RUT	TURNRUT
TURNON	RUT	TURNONRUT
TUSKS	UT	TUSKSUT
TUT	UT	TUTUT
TUTEE	TUT	TUTEETUT
TUTS	TUT	TUTSTUT
TUTU	TUT	TUTUTUT
TUX	UT	TUXUT
UKELELE	LEKU	UKELELELEKU
ULUS	ULU	ULUSULU
UMM	MU	UMMMU
UMP	MU	UMPMU
UNDERBRED	NU	UNDERBREDNU
UNDID	NU	UNDIDNU
UNLEVEL	NU	UNLEVELNU
UNS	NU	UNSNU
UNSEXES	NU	UNSEXESNU
UTILE	LITU	UTILELITU
VEDETTE	DEV	VEDETTEDEV
VELD	LEV	VELDLEV
VERA	REV	VERAREV
VERB	REV	VERBREV
VERSES	REV	VERSESREV
VERSOS	REV	VERSOSREV
VERSTS	REV	VERSTSREV
VERSUS	REV	VERSUSREV
VERT	REV	VERTREV
VERY	REV	VERYREV
VUGG	GUV	VUGGGUV
WAB	AW	WABAW
WACK	CAW	WACKCAW
WAD	AW	WADAW
WADDED	DAW	WADDEDDAW
WADE	DAW	WADEDAW
WADED	AW	WADEDAW
WADI	DAW	WADIDAW
WADS	DAW	WADSDAW
WADY	DAW	WADYDAW
WAE	AW	WAEAW
WAFF	AW	WAFFAW
WAG	AW	WAGAW
WAHOO	HAW	WAHOOHAW
WALE	LAW	WALELAW
WALK	LAW	WALKLAW
WALL	AW	WALLAW
WALL	LAW	WALLLAW
WALY	LAW	WALYLAW
WAN	AW	WANAW
WAND	NAW	WANDNAW
WANDERED	NAW	WANDEREDNAW
WANE	NAW	WANENAW
WANK	NAW	WANKNAW
WANS	NAW	WANSNAW
WANT	NAW	WANTNAW
WAP	AW	WAPAW
WAPITI	PAW	WAPITIPAW
WAPS	PAW	WAPSPAW
WAR	AW	WARAW
WARD	RAW	WARDRAW
WARDED	RAW	WARDEDRAW
WARDERS	REDRAW	WARDERSREDRAW
WARDS	DRAW	WARDSDRAW
WARE	RAW	WARERAW
WARK	RAW	WARKRAW
WARM	RAW	WARMRAW
WARN	RAW	WARNRAW
WARP	RAW	WARPRAW
WARRENER	RAW	WARRENERRAW
WARS	RAW	WARSRAW
WART	RAW	WARTRAW
WAS	AW	WASAW
WASH	SAW	WASHSAW
WASP	SAW	WASPSAW
WASPS	AW	WASPSAW
WAST	SAW	WASTSAW
WASTS	AW	WASTSAW
WAT	AW	WATAW
WATS	TAW	WATSTAW
WATT	AW	WATTAW
WATT	TAW	WATTTAW
WAVE	VAW	WAVEVAW
WAW	AW	WAWAW
WAWL	WAW	WAWLWAW
WAWS	WAW	WAWSWAW
WAX	AW	WAXAW
WAY	AW	WAYAW
WEDDED	DEW	WEDDEDDEW
WEDS	DEW	WEDSDEW
WEFT	FEW	WEFTFEW
WEND	NEW	WENDNEW
WENDED	NEW	WENDEDNEW
WENS	NEW	WENSNEW
WEPT	PEW	WEPTPEW
WETS	TEW	WETSTEW
WOE	OW	WOEOW
WOG	OW	WOGOW
WOK	OW	WOKOW
WOLD	LOW	WOLDLOW
WOLF	LOW	WOLFLOW
WOLFERS	REFLOW	WOLFERSREFLOW
WOLFS	FLOW	WOLFSFLOW
WOMB	MOW	WOMBMOW
WON	OW	WONOW
WONDERED	NOW	WONDEREDNOW
WONK	NOW	WONKNOW
WONKS	KNOW	WONKSKNOW
WONKY	KNOW	WONKYKNOW
WONS	NOW	WONSNOW
WONT	NOW	WONTNOW
WOO	OW	WOOOW
WOP	OW	WOPOW
WOPS	POW	WOPSPOW
WORD	ROW	WORDROW
WORDED	ROW	WORDEDROW
WORE	ROW	WOREROW
WORK	ROW	WORKROW
WORM	ROW	WORMROW
WORN	ROW	WORNROW
WORSES	ROW	WORSESROW
WORSTS	ROW	WORSTSROW
WORT	ROW	WORTROW
WORTH	TROW	WORTHTROW
WORTS	TROW	WORTSTROW
WOS	OW	WOSOW
WOST	SOW	WOSTSOW
WOT	OW	WOTOW
WOTS	TOW	WOTSTOW
WOVE	VOW	WOVEVOW
WOW	OW	WOWOW
WOWS	WOW	WOWSWOW
XENON	EX	XENONEX
YAFF	AY	YAFFAY
YAG	AY	YAGAY
YAGI	GAY	YAGIGAY
YAGS	GAY	YAGSGAY
YAH	AY	YAHAY
YAHOO	HAY	YAHOOHAY
YAK	AY	YAKAY
YAKS	KAY	YAKSKAY
YALD	LAY	YALDLAY
YAM	AY	YAMAY
YAMS	MAY	YAMSMAY
YANG	NAY	YANGNAY
YANK	NAY	YANKNAY
YAP	AY	YAPAY
YAPS	PAY	YAPSPAY
YAR	AY	YARAY
YARD	RAY	YARDRAY
YARDED	RAY	YARDEDRAY
YARDS	DRAY	YARDSDRAY
YARE	RAY	YARERAY
YARER	AY	YARERAY
YARN	RAY	YARNRAY
YAW	AY	YAWAY
YAWL	WAY	YAWLWAY
YAWN	WAY	YAWNWAY
YAWP	WAY	YAWPWAY
YAWS	WAY	YAWSWAY
YAY	AY	YAYAY
YAYS	YAY	YAYSYAY
YELK	LEY	YELKLEY
YELL	LEY	YELLLEY
YELP	LEY	YELPLEY
YOB	OY	YOBOY
YOBS	BOY	YOBSBOY
YOD	OY	YODOY
YODELED	OY	YODELEDOY
YODELLED	OY	YODELLEDOY
YOK	OY	YOKOY
YOM	OY	YOMOY
YOMIM	OY	YOMIMOY
YON	OY	YONOY
YOU	OY	YOUOY
YOW	OY	YOWOY
YUGA	GUY	YUGAGUY
